District_code,State_name,District_name,Population,Literate,Below_Primary_Education,Primary_Education,Middle_Education,Secondary_Education,Higher_Education,Graduate_Education,Other_Education,Literate_Education,Illiterate_Education,Total_Education
1,JAMMU AND KASHMIR,Kupwara,870354,439654,60616,101642,99947,74948,39709,21751,6402,405015,289765,694780
2,JAMMU AND KASHMIR,Badgam,753745,335649,68336,80862,83141,66459,41367,27950,6857,374972,342646,717618
3,JAMMU AND KASHMIR,Leh(Ladakh),133487,93770,10452,15181,17900,16265,8923,6197,575,75493,32637,108130
4,JAMMU AND KASHMIR,Kargil,140802,86236,12732,19083,20874,16938,9826,3077,408,82938,39854,122792
5,JAMMU AND KASHMIR,Punch,476835,261724,55762,72024,69219,46062,29517,13962,1884,288430,164044,452474
6,JAMMU AND KASHMIR,Rajouri,642415,364109,70996,91859,108785,65921,35804,18576,3036,394977,242306,637283
7,JAMMU AND KASHMIR,Kathua,616435,389204,69396,82715,106411,91522,47694,24330,4504,426572,181297,607869
8,JAMMU AND KASHMIR,Baramula,1008039,545149,76778,117000,137510,107837,57932,48285,9708,555050,350119,905169
9,JAMMU AND KASHMIR,Bandipore,392232,185979,34064,47240,48849,35630,18644,12721,2268,199416,163648,363064
10,JAMMU AND KASHMIR,Srinagar,1236829,748584,88911,173309,178723,176409,132727,121856,32114,904049,310225,1214274
11,JAMMU AND KASHMIR,Ganderbal,297446,143276,25817,38735,38375,28247,15005,9633,2212,158024,116734,274758
12,JAMMU AND KASHMIR,Pulwama,560440,293958,36201,54808,73991,67368,40931,31286,5897,310482,190369,500851
13,JAMMU AND KASHMIR,Shupiyan,266215,136500,26468,29593,36939,28617,16501,10782,2010,150910,107053,257963
14,JAMMU AND KASHMIR,Anantnag,1078692,545532,73719,99059,129174,97121,52407,41570,9160,502210,337265,839475
15,JAMMU AND KASHMIR,Kulgam,424483,209085,36066,47268,60470,45383,24214,18240,3190,234831,175199,410030
16,JAMMU AND KASHMIR,Doda,409936,219083,43794,47350,62719,48359,31416,12647,1846,248131,163565,411696
17,JAMMU AND KASHMIR,Ramban,283713,124065,33971,35284,35115,22591,13331,4923,1498,146713,141812,288525
18,JAMMU AND KASHMIR,Kishtwar,230696,107506,25022,25675,27745,19550,14521,5438,2529,120480,101166,221646
19,JAMMU AND KASHMIR,Udhampur,554985,322354,58567,80129,86008,55024,29657,17345,4030,330760,194838,525598
20,JAMMU AND KASHMIR,Reasi,314667,150542,33411,40215,36184,24066,14064,4733,575,153248,143293,296541
21,JAMMU AND KASHMIR,Jammu,1529958,1137135,135391,185962,253542,261852,159257,146501,30616,1173121,268279,1441400
22,JAMMU AND KASHMIR,Samba,318898,228139,29138,41233,59931,61407,30503,14055,2600,238867,65643,304510
23,HIMACHAL PRADESH,Chamba,519080,323842,56272,96789,67653,64515,40440,15506,3252,344427,154575,499002
24,HIMACHAL PRADESH,Kangra,1510075,1152640,127699,243617,223099,284124,192936,91236,13577,1176288,271892,1448180
25,HIMACHAL PRADESH,Lahul AND Spiti,31564,21845,3776,5042,4011,3934,3557,2378,119,22817,6515,29332
26,HIMACHAL PRADESH,Kullu,437903,307672,48384,77363,61854,58122,39081,23168,2377,310349,103136,413485
27,HIMACHAL PRADESH,Mandi,999777,723747,100052,159043,132147,180188,128549,54139,9350,763468,218570,982038
28,HIMACHAL PRADESH,Hamirpur,454768,358091,37327,71107,72114,91184,64363,35620,5263,376978,72551,449529
29,HIMACHAL PRADESH,Una,521173,399715,51838,87913,81256,105204,60626,32120,5511,424468,87735,512203
30,HIMACHAL PRADESH,Bilaspur,381956,287620,35817,59489,53515,64730,45695,25474,3241,287961,65864,353825
31,HIMACHAL PRADESH,Solan,580320,428578,50331,89407,83992,95232,59363,36803,8280,423408,104084,527492
32,HIMACHAL PRADESH,Sirmaur,529855,362645,57853,100123,78103,67080,38282,23352,4048,368841,140486,509327
33,HIMACHAL PRADESH,Shimla,814010,612642,69967,113536,113305,141490,95341,80414,9748,623801,137576,761377
34,HIMACHAL PRADESH,Kinnaur,84121,60699,9400,13749,11437,11140,7871,5118,713,59428,16944,76372
35,PUNJAB,Gurdaspur,2298323,1634719,180897,315156,290618,372317,243539,104345,22107,1528979,478020,2006999
36,PUNJAB,Kapurthala,815168,576567,71698,127031,112774,128828,77442,48221,9501,575495,174995,750490
37,PUNJAB,Jalandhar,2193590,1622537,183441,333736,304652,339758,216646,162965,34576,1575774,387809,1963583
38,PUNJAB,Hoshiarpur,1586625,1199699,143871,256127,238975,301435,176013,93618,17427,1227466,294723,1522189
39,PUNJAB,Shahid Bhagat Singh Nagar,612310,438459,53709,111242,94286,101970,61643,26893,5703,455446,133275,588721
40,PUNJAB,Fatehgarh Sahib,600163,426033,51897,102257,83931,95073,59555,34990,4607,432310,142314,574624
41,PUNJAB,Ludhiana,3498739,2560225,277247,488129,443759,527568,318876,272280,44240,2372099,631980,3004079
42,PUNJAB,Moga,995746,627889,98764,158812,116716,128693,85642,37417,11956,638000,306336,944336
43,PUNJAB,Firozpur,2029074,1227511,196971,306838,226433,221806,147698,82448,25734,1207928,714869,1922797
44,PUNJAB,Muktsar,901896,524848,90240,137470,101852,104682,62612,36905,10666,544427,340886,885313
45,PUNJAB,Faridkot,617508,381285,53734,89433,71178,75419,48360,29838,5790,373752,204895,578647
46,PUNJAB,Bathinda,1388525,844868,117795,182796,145626,163928,96329,70240,16666,793380,438529,1231909
47,PUNJAB,Mansa,769751,423560,75708,106162,84553,85953,48663,27461,5658,434158,311513,745671
48,PUNJAB,Patiala,1895686,1266791,173890,283837,239609,256826,157435,141947,27272,1280816,518772,1799588
49,PUNJAB,Amritsar,2490656,1684770,197944,313874,283819,328229,203656,142399,15879,1485800,540010,2025810
50,PUNJAB,Tarn Taran,1119627,666162,106878,165659,118366,147856,83290,21322,5077,648448,381879,1030327
51,PUNJAB,Rupnagar,684627,502731,53005,107715,98135,116836,68794,38823,9388,492696,124100,616796
53,PUNJAB,Sangrur,1655169,1002077,163251,250833,197901,220210,130155,73636,18393,1054379,570103,1624482
54,PUNJAB,Barnala,595527,359831,49367,90971,66695,81545,43467,23657,4665,360367,212388,572755
55,CHANDIGARH,Chandigarh,1055450,805438,80406,118667,114209,124707,98786,174528,20188,731491,184265,915756
56,UTTARAKHAND,Uttarkashi,330086,215126,43442,46625,47640,30901,24989,18882,981,213460,83896,297356
57,UTTARAKHAND,Chamoli,391605,280556,47447,68435,67519,47703,32557,27168,2367,293196,61950,355146
58,UTTARAKHAND,Rudraprayag,242285,170933,30562,50288,44605,28916,21131,15096,440,191038,45428,236466
59,UTTARAKHAND,Tehri Garhwal,618931,407994,72163,103462,95417,74008,58434,30704,2073,436261,133013,569274
60,UTTARAKHAND,Dehradun,1696694,1259506,142130,236027,240639,206730,187700,247622,26644,1287492,296538,1584030
61,UTTARAKHAND,Garhwal,687271,494889,91101,107794,111671,95590,74219,52076,5638,538089,123071,661160
62,UTTARAKHAND,Pithoragarh,483439,345550,63591,87585,90983,56591,42086,28375,2237,371448,88036,459484
63,UTTARAKHAND,Bageshwar,259898,179483,38113,47788,50340,31224,20785,10900,675,199825,49539,249364
64,UTTARAKHAND,Almora,622506,436497,90864,120029,115810,76148,53026,37742,2263,495882,109556,605438
65,UTTARAKHAND,Champawat,259648,177726,36127,48093,45766,23610,18360,15110,1317,188383,62429,250812
66,UTTARAKHAND,Nainital,954605,696500,90915,155681,157875,115317,98851,89101,6200,713940,166573,880513
67,UTTARAKHAND,Udham Singh Nagar,1648902,1037839,179602,302653,232381,169274,113661,111062,11786,1120419,438598,1559017
68,UTTARAKHAND,Hardwar,1890422,1178354,245515,336790,243719,165003,114114,134182,29377,1268700,580970,1849670
69,HARYANA,Panchkula,561293,405318,45607,73584,60177,69163,48306,83256,8466,388559,119222,507781
70,HARYANA,Ambala,1128350,818025,89558,170110,161844,163544,97980,91472,18727,793235,222031,1015266
71,HARYANA,Yamunanagar,1214205,832457,107222,194654,164652,159311,99170,82532,18666,826207,319428,1145635
72,HARYANA,Kurukshetra,964655,646893,94530,145392,118107,120790,81964,71007,10999,642789,266638,909427
73,HARYANA,Kaithal,1074304,646529,119345,158239,124682,117753,82297,51043,9111,662470,369869,1032339
74,HARYANA,Karnal,1505324,978013,155839,231354,188040,183590,124790,101387,19186,1004186,429220,1433406
75,HARYANA,Panipat,1205437,786599,118873,170565,143466,141473,91756,75774,10977,752884,296212,1049096
76,HARYANA,Sonipat,1450001,998316,138489,200458,182396,224639,150760,101186,19261,1017189,344813,1362002
77,HARYANA,Jind,1334152,832758,136892,185626,151682,154773,107994,64599,14277,815843,419624,1235467
78,HARYANA,Fatehabad,942011,557578,103541,136663,99948,93526,61476,37741,9504,542399,344534,886933
79,HARYANA,Sirsa,1295189,782897,141766,201349,153263,134559,83373,61620,16698,792628,412353,1204981
80,HARYANA,Hisar,1743931,1114311,197303,230074,194595,202792,144626,105346,19031,1093767,505251,1599018
81,HARYANA,Bhiwani,1634445,1069871,186145,223049,198307,218631,148995,104875,13786,1093788,459364,1553152
82,HARYANA,Rohtak,1061204,747582,117097,150903,140782,168499,109596,100346,21134,808357,248795,1057152
83,HARYANA,Jhajjar,958405,676091,90737,109829,115794,145258,97457,58826,9387,627288,201028,828316
84,HARYANA,Mahendragarh,922088,630255,94273,135849,126291,132765,94245,60296,10353,654072,245602,899674
85,HARYANA,Rewari,900332,636947,81280,120860,122617,139646,95807,65143,9820,635173,206827,842000
86,HARYANA,Gurgaon,1514432,1111116,126920,177453,175370,219200,150120,233402,41366,1123831,263720,1387551
87,HARYANA,Mewat,1089263,454897,125261,135842,67299,41836,22265,12453,5527,410483,619284,1029767
88,HARYANA,Faridabad,1809733,1272739,137902,220384,198551,282666,178846,259933,27864,1306146,346567,1652713
89,HARYANA,Palwal,1042708,599796,125474,142156,113940,102626,65963,43780,8373,602312,393825,996137
90,NCT OF DELHI,North West,3656539,2707855,228507,571255,607092,613393,519808,465677,22436,3028168,416720,3444888
91,NCT OF DELHI,North,887978,681517,58952,133915,142788,126121,97744,107099,11098,677717,125277,802994
92,NCT OF DELHI,North East,2241624,1611588,206524,500493,488767,341540,212438,122983,9199,1881944,257966,2139910
93,NCT OF DELHI,East,1709346,1352998,86484,219061,260094,267825,235187,246988,18644,1334283,169693,1503976
94,NCT OF DELHI,New Delhi,142004,114179,4641,11728,15326,15942,17742,23934,2186,91499,10098,101597
95,NCT OF DELHI,Central,582320,442360,34122,80924,96755,83244,62124,80251,6097,443517,87286,530803
96,NCT OF DELHI,West,2543243,1961179,157606,318376,365913,369114,327114,440295,54376,2032794,308139,2340933
97,NCT OF DELHI,South West,2292958,1787689,152945,255177,313817,335645,308513,400800,47723,1814620,278832,2093452
98,NCT OF DELHI,South,2731929,2078402,191659,368772,400595,430091,354078,458858,52503,2256556,328287,2584843
99,RAJASTHAN,Ganganagar,1969168,1193343,237042,314107,238397,163098,105734,104071,19396,1181845,710223,1892068
100,RAJASTHAN,Hanumangarh,1774692,1034136,239601,273441,219194,153628,104087,84185,14416,1088552,723454,1812006
101,RAJASTHAN,Bikaner,2363937,1278801,410155,333211,254335,143669,80296,101714,18577,1341957,1015331,2357288
102,RAJASTHAN,Churu,2039547,1149269,336671,302022,237220,161520,100677,77282,13320,1228712,910226,2138938
103,RAJASTHAN,Jhunjhunun,2137045,1370360,296093,305626,301866,256621,192240,158936,25286,1536668,712584,2249252
104,RAJASTHAN,Alwar,3674179,2182476,492781,492981,468628,324050,230415,222622,31390,2262867,1384905,3647772
105,RAJASTHAN,Bharatpur,2548462,1480869,363676,330336,314953,211938,147520,132571,23311,1524305,1104824,2629129
106,RAJASTHAN,Dhaulpur,1206516,683098,207566,172914,132964,77360,45590,37856,8194,682444,552106,1234550
107,RAJASTHAN,Karauli,1458248,805849,220644,193938,170399,104208,69443,67639,14402,840673,668926,1509599
108,RAJASTHAN,Sawai Madhopur,1335551,741748,205450,172925,151108,87349,57625,70870,14384,759711,586492,1346203
109,RAJASTHAN,Dausa,1634409,938051,229035,235474,208537,135234,92559,90833,13764,1005436,681980,1687416
110,RAJASTHAN,Jaipur,6626178,4300965,819004,875940,823570,659389,455527,703673,96562,4433665,2046038,6479703
111,RAJASTHAN,Sikar,2677333,1652117,369959,438872,367412,282595,200430,181282,19321,1859871,967497,2827368
112,RAJASTHAN,Nagaur,3307743,1758624,513871,486057,388822,242053,147701,117444,14853,1910801,1533137,3443938
113,RAJASTHAN,Jodhpur,3687165,2031532,497762,512035,405132,259304,154789,177199,30720,2036941,1591957,3628898
114,RAJASTHAN,Jaisalmer,669919,308653,109484,71132,41264,20142,12759,10604,1720,267105,397649,664754
115,RAJASTHAN,Barmer,2603751,1188322,406804,352636,219932,101291,52272,39533,7328,1179796,1501858,2681654
116,RAJASTHAN,Jalor,1828730,829582,270997,277152,181691,75304,32366,25210,7850,870570,1033534,1904104
117,RAJASTHAN,Sirohi,1036346,476806,117971,147381,110385,58213,30724,27076,5251,497001,577092,1074093
118,RAJASTHAN,Pali,2037573,1085693,293818,359329,271312,144581,71472,67021,9403,1216936,983050,2199986
119,RAJASTHAN,Ajmer,2583052,1526673,379043,394576,313680,200191,130608,172683,28138,1618919,1034334,2653253
120,RAJASTHAN,Tonk,1421326,749659,237191,190750,154825,91853,64431,67155,9919,816124,661902,1478026
121,RAJASTHAN,Bundi,1110906,585044,153500,159218,121104,63248,41227,41052,6460,585809,553622,1139431
122,RAJASTHAN,Bhilwara,2408523,1256126,398993,338296,258990,141250,92785,106667,10928,1347909,1180456,2528365
123,RAJASTHAN,Rajsamand,1156597,619139,190090,190388,140839,72969,41063,34286,4732,674367,544517,1218884
124,RAJASTHAN,Dungarpur,1388552,681591,238847,175059,114245,60656,42887,39312,4834,675840,764563,1440403
125,RAJASTHAN,Banswara,1797485,829343,240067,190259,137780,75011,50438,47094,8145,748794,1040914,1789708
126,RAJASTHAN,Chittaurgarh,1544338,821825,245603,225700,170455,90889,58129,67155,10768,868699,715545,1584244
127,RAJASTHAN,Kota,1951014,1298345,286676,294591,250092,172538,118710,167778,27485,1317870,588142,1906012
128,RAJASTHAN,Baran,1222755,693307,203489,194024,144190,76209,46847,49939,8057,722755,545842,1268597
129,RAJASTHAN,Jhalawar,1411129,739792,226614,203488,143108,73388,46267,47985,6972,747822,696680,1444502
130,RAJASTHAN,Udaipur,3068420,1582629,442946,386075,277392,164290,102085,142672,20010,1535470,1528671,3064141
131,RAJASTHAN,Pratapgarh,867848,401515,142397,111276,70969,35206,21854,19109,2137,402948,488621,891569
132,UTTAR PRADESH,Saharanpur,3466382,2077108,474060,600668,431491,256510,163463,154153,10083,2090428,1279517,3369945
133,UTTAR PRADESH,Muzaffarnagar,4143512,2417339,826387,780470,531913,281747,148770,98691,5608,2673586,1431537,4105123
134,UTTAR PRADESH,Bijnor,3682713,2135393,498971,827447,549594,255028,159528,148185,14658,2453411,1308683,3762094
135,UTTAR PRADESH,Moradabad,4772006,2263848,635957,725118,492338,296210,186311,186489,23372,2545795,2097292,4643087
136,UTTAR PRADESH,Rampur,2335819,1043666,278477,374898,171242,85117,51703,43839,3169,1008445,1235413,2243858
137,UTTAR PRADESH,Jyotiba Phule Nagar,1840221,983110,251669,352835,230640,161282,164763,69522,3021,1233732,520215,1753947
138,UTTAR PRADESH,Meerut,3443689,2141488,412280,495861,469403,359944,254337,275076,36096,2302997,990312,3293309
139,UTTAR PRADESH,Baghpat,1303048,797970,139646,272939,215070,132197,79475,44164,3730,887221,376700,1263921
140,UTTAR PRADESH,Ghaziabad,4681645,3123264,534606,858286,797473,597661,475439,255949,26399,3545813,885070,4430883
141,UTTAR PRADESH,Gautam Buddha Nagar,1648115,1122947,201277,330623,283031,218587,194796,101645,5058,1335017,342284,1677301
142,UTTAR PRADESH,Bulandshahr,3499171,2031656,443641,540754,475146,338138,217882,151182,17796,2184539,1185318,3369857
143,UTTAR PRADESH,Aligarh,3673889,2092567,456870,491605,443958,334738,216997,172585,20498,2137251,1352181,3489432
144,UTTAR PRADESH,Mahamaya Nagar,1564708,942572,181444,297282,269717,166861,89435,49812,5386,1059937,430814,1490751
145,UTTAR PRADESH,Mathura,2547184,1507746,303291,420976,344961,233264,155937,103102,10262,1571793,691359,2263152
146,UTTAR PRADESH,Agra,4418797,2680510,600839,904836,647340,450571,317618,199395,20781,3141380,963202,4104582
147,UTTAR PRADESH,Firozabad,2498156,1521806,324525,416295,368905,277163,166249,108627,11313,1673077,672115,2345192
148,UTTAR PRADESH,Mainpuri,1868529,1203885,234774,353287,319158,230731,144516,111696,12281,1406443,519493,1925936
149,UTTAR PRADESH,Budaun,3681896,1547477,556130,585283,295943,154425,86760,64222,7291,1750054,1946345,3696399
150,UTTAR PRADESH,Bareilly,4448359,2191759,717585,641251,442110,272840,172554,146446,16806,2409592,1744527,4154119
151,UTTAR PRADESH,Pilibhit,2031007,1061095,294135,281158,240057,117838,77602,66129,9713,1086632,977839,2064471
152,UTTAR PRADESH,Shahjahanpur,3006538,1490930,451571,476064,315873,158430,96308,87355,8885,1594486,1324615,2919101
153,UTTAR PRADESH,Kheri,4021243,2034044,717340,621684,442748,223669,129627,128548,10846,2274462,1833578,4108040
154,UTTAR PRADESH,Sitapur,4483992,2283733,714304,656401,482220,221898,136383,127750,8775,2347731,2141696,4489427
155,UTTAR PRADESH,Hardoi,4092845,2221601,741817,906861,510507,247265,138583,103523,9048,2657604,1481604,4139208
156,UTTAR PRADESH,Unnao,3108367,1773584,501457,512965,415378,240024,136688,101934,7173,1915619,1130103,3045722
157,UTTAR PRADESH,Lucknow,4589838,3127260,489898,554301,552171,428121,378742,639260,52132,3094625,1146880,4241505
158,UTTAR PRADESH,Rae Bareli,3405559,1965843,540661,538301,477689,270775,182823,153041,15662,2178952,1286726,3465678
159,UTTAR PRADESH,Farrukhabad,1885204,1092677,270550,330084,257279,184298,115069,110391,9368,1277039,710960,1987999
160,UTTAR PRADESH,Kannauj,1656616,1017087,237853,283674,263749,175582,107628,95072,7194,1170752,543034,1713786
161,UTTAR PRADESH,Etawah,1581810,1062003,171216,292852,298700,195192,121283,118571,13400,1211214,397708,1608922
162,UTTAR PRADESH,Auraiya,1379545,930836,133123,291837,282449,168866,101542,79012,6531,1063360,276224,1339584
163,UTTAR PRADESH,Kanpur Dehat,1796184,1170243,235341,344866,341845,223529,157167,97740,5930,1406418,475166,1881584
164,UTTAR PRADESH,Kanpur Nagar,4581268,3243022,338620,766906,794860,651228,515772,396565,26827,3490778,676306,4167084
165,UTTAR PRADESH,Jalaun,1689974,1075196,169207,327534,282919,167911,104699,106888,10399,1169557,461666,1631223
166,UTTAR PRADESH,Jhansi,1998603,1304513,184997,370685,341371,186348,99814,92586,11783,1287584,483088,1770672
167,UTTAR PRADESH,Lalitpur,1221592,641191,185575,202692,154118,61543,32237,34658,3535,674358,509536,1183894
168,UTTAR PRADESH,Hamirpur,1104285,653299,159593,238344,211029,103334,59914,59612,4094,835920,364848,1200768
169,UTTAR PRADESH,Mahoba,875958,488106,119002,141201,131165,60400,33810,37165,3926,526669,403649,930318
170,UTTAR PRADESH,Banda,1799410,1002937,325773,415195,249238,114783,61702,63112,5728,1235531,588025,1823556
171,UTTAR PRADESH,Chitrakoot,991730,531072,168472,174106,124256,69641,40266,35826,3660,616227,383908,1000135
172,UTTAR PRADESH,Fatehpur,2632733,1512166,409875,463642,376472,227119,134445,116445,10212,1738210,895178,2633388
173,UTTAR PRADESH,Pratapgarh,3209141,1931559,427626,558350,456752,332742,238011,197846,20047,2231374,1059636,3291010
174,UTTAR PRADESH,Kaushambi,1599596,813424,184229,253910,180825,146757,89011,45341,5115,905188,670750,1575938
175,UTTAR PRADESH,Allahabad,5954391,3665727,823863,934881,738076,596615,502826,428871,36764,4061896,1756098,5817994
176,UTTAR PRADESH,Bara Banki,3260699,1692458,533140,420824,350564,197780,132332,113799,12281,1760720,1540841,3301561
177,UTTAR PRADESH,Faizabad,2470996,1450901,356093,361114,347114,231129,176303,179996,18947,1670696,981915,2652611
178,UTTAR PRADESH,Ambedkar Nagar,2397888,1486939,342667,392873,353570,247028,172872,194387,15458,1718855,813502,2532357
179,UTTAR PRADESH,Sultanpur,3797117,2239902,460210,637015,526973,306046,188848,176414,15277,2310783,1118891,3429674
180,UTTAR PRADESH,Bahraich,3487731,1398368,447648,493760,215939,104762,65106,47690,7028,1381933,1920966,3302899
181,UTTAR PRADESH,Shrawasti,1117361,423313,155698,97160,56242,29567,19744,15648,1535,375594,701550,1077144
182,UTTAR PRADESH,Balrampur,2148665,868357,379253,227932,122911,65516,40633,37109,2777,876131,1332817,2208948
183,UTTAR PRADESH,Gonda,3433919,1679994,678171,425584,305644,192664,144067,118176,8722,1873028,1620782,3493810
184,UTTAR PRADESH,Siddharthnagar,2559297,1228926,676987,335977,204260,110056,73465,56516,10526,1467787,1217027,2684814
185,UTTAR PRADESH,Basti,2464464,1393783,470355,349221,324085,211477,162961,143642,13030,1674771,1021192,2695963
186,UTTAR PRADESH,Sant Kabir Nagar,1715183,954949,341757,290532,205875,129442,86528,63506,8882,1126522,683053,1809575
187,UTTAR PRADESH,Mahrajganj,2684703,1419144,456350,388464,308064,185236,129222,95863,11219,1574418,1252595,2827013
188,UTTAR PRADESH,Gorakhpur,4440895,2700328,873031,618398,560246,425913,316166,273903,36253,3103910,1453960,4557870
189,UTTAR PRADESH,Kushinagar,3564544,1954820,836856,424892,367405,249265,170911,119625,11970,2180924,1550315,3731239
190,UTTAR PRADESH,Deoria,3100946,1875239,602403,473097,449571,372031,277548,194341,23334,2392325,1130108,3522433
191,UTTAR PRADESH,Azamgarh,4613913,2771917,831966,1344726,879745,489060,312571,158303,8087,4024458,1218146,5242604
192,UTTAR PRADESH,Mau,2205968,1363044,344570,410737,320743,256784,209493,150462,15771,1708560,659237,2367797
193,UTTAR PRADESH,Ballia,3239774,1963590,436021,515010,443440,409484,323582,200434,20283,2348254,1032533,3380787
194,UTTAR PRADESH,Jaunpur,4494204,2731677,665376,939616,769693,520111,353996,256398,25909,3531099,1344789,4875888
195,UTTAR PRADESH,Ghazipur,3620268,2197549,566504,691057,563310,449909,334003,186306,12795,2803884,1008996,3812880
196,UTTAR PRADESH,Chandauli,1952756,1174606,295979,367768,276638,196240,135962,88299,7586,1368472,543247,1911719
197,UTTAR PRADESH,Varanasi,3676841,2403903,467782,608174,557052,447926,351391,281652,34841,2748818,906367,3655185
199,UTTAR PRADESH,Mirzapur,2496970,1428683,361642,421577,340261,232189,177109,140668,17680,1691126,868542,2559668
200,UTTAR PRADESH,Sonbhadra,1862559,985708,306218,297226,212565,120822,82614,63846,9357,1092648,745126,1837774
201,UTTAR PRADESH,Etah,1774480,1055202,238019,214091,201984,178434,119665,88607,8092,1048892,718310,1767202
202,UTTAR PRADESH,Kanshiram Nagar,1436719,724850,256688,193410,150247,108558,61662,48079,4981,823625,648166,1471791
203,BIHAR,Pashchim Champaran,3935042,1759481,1053481,543965,250243,159563,98732,70669,6035,2182688,1710878,3893566
204,BIHAR,Purba Champaran,5099371,2276957,1280809,982506,450631,241118,121594,68781,5149,3150588,2142757,5293345
205,BIHAR,Sheohar,656246,283698,128209,91277,37063,25657,16031,10091,661,308989,348078,657067
206,BIHAR,Sitamarhi,3423574,1436794,733380,394422,196321,136500,92783,70549,11936,1635891,1852765,3488656
207,BIHAR,Madhubani,4487379,2155338,783888,771417,520875,303114,170563,137780,11352,2698989,2003079,4702068
208,BIHAR,Supaul,2229076,1033283,467768,269737,157787,99530,69665,45726,5850,1116063,1220268,2336331
209,BIHAR,Araria,2811569,1195768,625357,426625,206161,112955,68177,39627,6938,1485840,1653766,3139606
210,BIHAR,Kishanganj,1690400,745056,356401,235779,89025,42778,25989,15386,3761,769119,945397,1714516
211,BIHAR,Purnia,3264619,1332326,668690,360243,184327,119259,83226,59996,11116,1486857,1798786,3285643
212,BIHAR,Katihar,3071029,1280190,472616,444260,237243,133811,88498,57114,11896,1445438,1705551,3150989
213,BIHAR,Madhepura,2001762,834577,340813,189431,114474,99437,79891,44955,6509,875510,1202278,2077788
214,BIHAR,Saharsa,1900661,804996,348300,194897,104182,90182,64560,47051,6016,855188,1151349,2006537
215,BIHAR,Darbhanga,3937385,1816634,672797,490534,332382,224622,152540,129597,26073,2028545,2203198,4231743
216,BIHAR,Muzaffarpur,4801062,2509232,1092952,743623,419433,299475,194920,138916,14475,2903794,1924438,4828232
217,BIHAR,Gopalganj,2562012,1382998,540603,470828,291624,223776,123249,79109,7690,1736879,977719,2714598
218,BIHAR,Siwan,3330464,1930175,689880,612635,445257,355277,186817,119164,12091,2421121,1207119,3628240
219,BIHAR,Saran,3951862,2157454,793945,693465,433759,361171,213251,148065,9848,2653504,1313700,3967204
220,BIHAR,Vaishali,3495021,1926740,810191,487594,370247,291392,178320,124448,9094,2271286,1479152,3750438
221,BIHAR,Samastipur,4261566,2142880,781038,710468,438908,284082,186153,129933,19126,2549708,1996651,4546359
222,BIHAR,Begusarai,2970541,1548673,577601,484502,291877,207136,144783,101836,14599,1822334,1242551,3064885
223,BIHAR,Khagaria,1666886,768028,350601,233494,130004,100555,65931,38697,5969,925251,903323,1828574
224,BIHAR,Bhagalpur,3037766,1573066,614644,524322,300767,247079,154643,118843,16119,1976417,1139715,3116132
225,BIHAR,Banka,2034763,965321,408188,386707,196305,120653,63103,35767,3922,1214645,879831,2094476
226,BIHAR,Munger,1367765,801817,226699,158699,146414,147152,101907,64469,4394,849734,498676,1348410
227,BIHAR,Lakhisarai,1000912,507270,172076,149312,111684,85807,48001,27261,3814,597955,450967,1048922
228,BIHAR,Sheikhpura,636342,328676,129673,110525,59529,52860,33856,19676,3399,409518,305609,715127
229,BIHAR,Nalanda,2877653,1519933,581978,486266,320839,274556,177358,133032,11159,1985188,1324385,3309573
230,BIHAR,Patna,5838465,3459679,1244842,1095655,920051,698351,463361,452340,46126,4920726,2590473,7511199
231,BIHAR,Bhojpur,2728407,1599151,581580,605307,367059,313509,163303,131137,10630,2172525,1005140,3177665
232,BIHAR,Buxar,1706352,989807,331675,420187,256124,178044,89306,64117,5224,1344677,457814,1802491
233,BIHAR,Kaimur (Bhabua),1626384,920276,318859,294927,210899,147315,86815,70169,9576,1138560,551317,1689877
234,BIHAR,Rohtas,2959918,1799832,535187,548971,399053,333053,194928,161555,16006,2188753,876443,3065196
235,BIHAR,Aurangabad,2540073,1466002,559512,482199,302662,253142,136783,91371,8329,1833998,784131,2618129
236,BIHAR,Gaya,4391418,2297613,902272,757690,447480,342254,191824,131163,12047,2784730,1953368,4738098
237,BIHAR,Nawada,2219146,1091012,601011,368649,195072,161127,95943,64585,3130,1489517,1091439,2580956
238,BIHAR,Jamui,1760405,858588,420472,317612,153973,104211,56137,29633,3439,1085477,765297,1850774
239,BIHAR,Jehanabad,1125313,618881,211761,165906,117558,112966,68748,45519,3539,725997,495877,1221874
240,BIHAR,Arwal,700843,386351,123288,118311,80704,81975,48822,27945,1435,482480,290095,772575
241,SIKKIM,North  District,43709,30450,6030,8276,6181,3223,1993,1406,273,27382,7673,35055
242,SIKKIM,West District,136435,93432,30518,30827,19973,10005,6439,4831,527,103120,28227,131347
243,SIKKIM,South District,146850,106741,24507,32427,22340,12415,7260,5766,488,105203,24395,129598
244,SIKKIM,East District,283583,214329,33578,53789,45602,29215,19258,20904,2682,205028,38142,243170
245,ARUNACHAL PRADESH,Tawang,49977,26073,4904,4730,4029,2140,1989,1379,667,19838,19203,39041
246,ARUNACHAL PRADESH,West Kameng,83947,48492,8836,10317,8428,5633,3987,2693,299,40193,25606,65799
247,ARUNACHAL PRADESH,East Kameng,78690,38449,11713,10487,8852,6213,4510,2330,142,44247,31763,76010
248,ARUNACHAL PRADESH,Papum Pare,176573,121048,15368,21956,21376,20007,17342,13840,926,110815,30360,141175
249,ARUNACHAL PRADESH,Upper Subansiri,83448,45278,10219,16118,15339,10348,8017,4276,473,64790,28364,93154
250,ARUNACHAL PRADESH,West Siang,112274,64746,14227,17675,15908,11441,8418,6030,521,74220,27956,102176
251,ARUNACHAL PRADESH,East Siang,99214,62576,9938,13713,13968,10937,9498,6540,525,65119,21543,86662
252,ARUNACHAL PRADESH,Upper Siang,35320,18195,3952,5584,4915,2935,2211,1349,46,20992,11209,32201
253,ARUNACHAL PRADESH,Changlang,148226,73174,20425,22537,17354,10032,5641,3633,834,80456,57290,137746
254,ARUNACHAL PRADESH,Tirap,111975,47974,13585,16989,12077,7834,4305,2134,182,57106,50628,107734
255,ARUNACHAL PRADESH,Lower Subansiri,83030,54057,8492,10821,11661,9861,7674,5230,295,54034,17273,71307
256,ARUNACHAL PRADESH,Kurung Kumey,92076,36606,12661,15054,12264,6997,4353,2031,299,53659,42621,96280
257,ARUNACHAL PRADESH,Dibang Valley,8004,4436,696,1258,1060,809,656,356,91,4926,2185,7111
258,ARUNACHAL PRADESH,Lower Dibang Valley,54080,31849,5875,7957,7351,5508,3570,2795,85,33141,14406,47547
259,ARUNACHAL PRADESH,Lohit,145726,83062,19306,25179,20643,13070,7612,5180,584,91574,52421,143995
260,ARUNACHAL PRADESH,Anjaw,21167,9990,2879,2946,2170,1167,793,502,98,10555,8723,19278
261,NAGALAND,Mon,250260,119626,37431,46055,30500,7628,3565,1772,107,127058,130529,257587
262,NAGALAND,Mokokchung,194622,159494,20259,43483,54035,27425,13077,10299,870,169448,22555,192003
263,NAGALAND,Zunheboto,140757,102881,16523,30889,35113,17282,8821,5560,1107,115295,25988,141283
264,NAGALAND,Wokha,166343,128208,15865,37024,41627,18746,10223,8030,401,131916,25048,156964
265,NAGALAND,Dimapur,378811,278037,34539,61815,80076,44343,26712,27532,2939,277956,58926,336882
266,NAGALAND,Phek,163418,105893,22494,32722,30434,12785,7268,5926,481,112110,44456,156566
267,NAGALAND,Tuensang,196596,117511,29602,40900,33514,15013,6008,2760,116,127913,66450,194363
268,NAGALAND,Longleng,50484,29859,7986,11884,8672,3458,1695,595,15,34305,18230,52535
269,NAGALAND,Kiphire,74004,41232,11197,15740,13645,5204,2052,997,76,48911,32120,81031
270,NAGALAND,Kohima,267988,197489,21654,46756,57726,30518,19855,23439,1770,201718,45802,247520
271,NAGALAND,Peren,95219,62204,9248,24527,20732,8082,3938,2169,75,68771,24790,93561
272,MANIPUR,Senapati,479148,264477,46757,81735,91395,62033,40438,24940,598,347896,191001,538897
273,MANIPUR,Tamenglong,140651,85006,11155,28461,26794,17867,11645,7102,270,103294,45317,148611
274,MANIPUR,Churachandpur,274143,195935,32860,67907,65475,38567,23284,14523,509,243125,57561,300686
275,MANIPUR,Bishnupur,237399,156333,15941,36011,50004,31775,20077,20074,1440,175322,67610,242932
276,MANIPUR,Thoubal,422168,269304,32396,69738,87932,55803,37899,28550,3214,315532,118088,433620
277,MANIPUR,Imphal West,517992,392626,32811,66042,104229,77472,60821,81876,9564,432815,87248,520063
278,MANIPUR,Imphal East,456113,324664,38436,69144,99202,60422,47390,50647,4102,369343,90250,459593
279,MANIPUR,Ukhrul,183998,129829,20670,29382,38350,31734,22729,15636,405,158906,42156,201062
280,MANIPUR,Chandel,144182,90302,17382,28163,30589,18971,12213,8105,240,115663,38191,153854
281,MIZORAM,Mamit,86364,60191,9328,19711,19949,10756,3180,1771,22,64717,20091,84808
282,MIZORAM,Kolasib,83955,65895,11367,18046,20399,9849,3473,2530,62,65726,14217,79943
283,MIZORAM,Aizawl,400309,340595,29332,68214,100103,78752,37701,31310,2058,347470,38248,385718
284,MIZORAM,Champhai,125745,100802,14491,31359,30454,16259,4956,4087,78,101684,15449,117133
285,MIZORAM,Serchhip,64937,54476,8771,14985,16237,9062,2915,2128,35,54133,5963,60096
286,MIZORAM,Lunglei,161428,121122,22181,33313,34774,19918,8503,5509,116,124314,32451,156765
287,MIZORAM,Lawngtlai,117894,62861,19890,21114,16629,10538,3763,2515,125,74574,54874,129448
288,MIZORAM,Saiha,56574,42233,8422,14151,12130,7269,3628,2204,69,47873,8787,56660
289,TRIPURA,West Tripura,1725739,1361354,248343,421485,451563,156277,88122,85405,13478,1464673,279053,1743726
290,TRIPURA,South Tripura,876001,646810,129846,223185,204201,70173,31690,26870,5160,691125,188363,879488
291,TRIPURA,Dhalai,378230,276217,64515,84516,74015,21430,9157,6425,890,260948,109130,370078
292,TRIPURA,North Tripura,693947,520402,129329,179547,158211,47160,22720,18419,3736,559122,156840,715962
293,MEGHALAYA,West Garo Hills,643291,358702,85733,129178,90963,70941,29404,10856,3547,420622,208900,629522
294,MEGHALAYA,East Garo Hills,317917,192147,51578,70679,52762,31328,9473,2484,298,218602,100781,319383
295,MEGHALAYA,South Garo Hills,142334,82062,25906,28921,21506,13858,3998,826,831,95846,44849,140695
296,MEGHALAYA,West Khasi Hills,383461,230678,80318,78208,45046,28417,12295,6450,541,251275,133244,384519
297,MEGHALAYA,Ribhoi,258840,155859,57680,58581,31103,20134,7632,3911,633,179674,78974,258648
298,MEGHALAYA,East Khasi Hills,825922,578030,118135,163729,127722,94579,58836,61639,9397,634037,168575,802612
299,MEGHALAYA,Jaintia Hills,395124,187527,67749,61526,34677,26748,13544,8039,2934,215217,165184,380401
300,ASSAM,Kokrajhar,887142,489305,116899,166013,154715,78788,39571,17287,2733,576006,340601,916607
301,ASSAM,Dhubri,1949258,922341,253638,299724,250242,100387,65082,34401,3863,1007337,992068,1999405
302,ASSAM,Goalpara,1008183,563577,124700,213510,183904,73683,39885,18294,3464,657440,375071,1032511
303,ASSAM,Barpeta,1693622,897058,210607,307884,300845,121924,87377,46947,8007,1083591,664161,1747752
304,ASSAM,Morigaon,957423,539902,130091,195656,179810,67969,40803,18462,2791,635582,351756,987338
305,ASSAM,Nagaon,2823768,1710716,392616,638088,576214,199792,115864,66994,10351,1999919,873197,2873116
306,ASSAM,Sonitpur,1924110,1108572,216097,416218,377653,141373,90385,49901,6412,1298039,627141,1925180
307,ASSAM,Lakhimpur,1042137,683486,126950,212080,217497,107326,82885,44212,4731,795681,275677,1071358
308,ASSAM,Dhemaji,686133,423028,79107,138838,136371,80804,55399,28006,2868,521393,194984,716377
309,ASSAM,Tinsukia,1327929,798322,150893,266717,276292,109805,61040,38152,7353,910252,417081,1327333
310,ASSAM,Dibrugarh,1326335,884531,143189,243607,301287,139813,89500,59380,6984,983760,340744,1324504
311,ASSAM,Sivasagar,1151050,813505,115378,208891,280517,158118,96939,53437,5554,918834,247114,1165948
312,ASSAM,Jorhat,1092256,794929,99454,201680,295444,128050,97025,62608,8433,892694,209170,1101864
313,ASSAM,Golaghat,1066888,721764,117393,223902,261192,111145,66197,36887,4084,820800,258897,1079697
314,ASSAM,Karbi Anglong,956313,557214,109324,212224,199289,93137,40602,18225,3426,676227,310093,986320
315,ASSAM,Dima Hasao,214102,140873,20780,43811,53736,27839,10859,5565,598,163188,57631,220819
316,ASSAM,Cachar,1736617,1174128,256855,447993,379469,156156,79766,45341,12951,1378531,357907,1736438
317,ASSAM,Karimganj,1228686,795297,198059,333885,257931,76685,39637,21408,7903,935508,303785,1239293
318,ASSAM,Hailakandi,659296,407366,88596,177984,139029,50056,28504,11608,4265,500042,173306,673348
319,ASSAM,Bongaigaon,738804,434078,93591,138294,133643,55924,35491,20221,2267,479431,260721,740152
320,ASSAM,Chirang,482162,259902,64999,92943,84682,37792,17702,6594,918,305630,172939,478569
321,ASSAM,Kamrup,1517542,995319,163849,290097,353861,154831,118849,55011,6444,1142942,392678,1535620
322,ASSAM,Kamrup Metropolitan,1253938,1001191,79177,160490,255522,148429,143478,167972,30795,985863,128773,1114636
323,ASSAM,Nalbari,771639,531771,75866,141690,192771,81507,71734,39368,3693,606629,188960,795589
324,ASSAM,Baksa,950075,572837,95444,195643,225635,96782,53446,15422,1839,684211,294784,978995
325,ASSAM,Darrang,928500,487039,119027,163277,161153,59039,47398,22267,3079,575240,375556,950796
326,ASSAM,Udalguri,831668,469926,101146,155720,162369,63394,34334,14001,1612,532576,306833,839409
327,WEST BENGAL,Darjiling,1846823,1315585,183479,344865,402415,176129,113905,110193,12851,1343837,415353,1759190
328,WEST BENGAL,Jalpaiguri,3872846,2498780,455854,765613,814395,292056,150360,129393,18916,2626587,1203423,3830010
329,WEST BENGAL,Koch Bihar,2819086,1850504,393492,595555,590626,209153,93119,81100,8712,1971757,873135,2844892
330,WEST BENGAL,Uttar Dinajpur,3007134,1489667,402590,488047,422777,163106,73395,59457,12723,1622095,1431264,3053359
331,WEST BENGAL,Dakshin Dinajpur,1676276,1083685,247675,323965,327064,135556,63286,52345,5190,1155081,534394,1689475
332,WEST BENGAL,Maldah,3988845,2086432,478902,629137,595551,238078,109719,92207,18330,2161924,1960034,4121958
333,WEST BENGAL,Murshidabad,7103807,4055834,837828,1428661,1210859,443254,230242,170051,25975,4346870,3031841,7378711
334,WEST BENGAL,Birbhum,3502404,2158447,417769,661190,622372,245201,122865,115743,15205,2200345,1346802,3547147
335,WEST BENGAL,Barddhaman,7717563,5247208,800473,1437198,1605634,698251,405935,439823,62616,5449930,2196886,7646816
336,WEST BENGAL,Nadia,5167600,3480555,605490,1093403,1052487,412193,236828,209562,25491,3635454,1570127,5205581
338,WEST BENGAL,Hugli,5519145,4078388,676265,1172797,1174912,515807,333658,380060,44252,4297751,1180806,5478557
339,WEST BENGAL,Bankura,3596674,2232992,450029,545200,686924,261478,143882,133465,20379,2241357,1417787,3659144
340,WEST BENGAL,Puruliya,2930115,1624905,299355,480046,528068,177459,91807,77621,10072,1664428,1272799,2937227
341,WEST BENGAL,Haora,4850029,3605206,516323,1059842,1084155,446743,284481,304594,37027,3733165,926661,4659826
342,WEST BENGAL,Kolkata,4496694,3588137,255171,597841,820902,555529,425245,691804,89701,3436193,410988,3847181
344,WEST BENGAL,Paschim Medinipur,5913457,4078412,831300,1139784,1289873,477973,262072,211437,35396,4247835,1689984,5937819
345,WEST BENGAL,Purba Medinipur,5095875,3923194,776367,1219166,1289927,444668,236549,184225,30677,4181579,1021541,5203120
346,JHARKHAND,Garhwa,1322784,653476,207665,195565,147446,87844,46882,28144,2830,716376,557852,1274228
347,JHARKHAND,Chatra,1042886,510061,200861,161729,102033,63670,35342,21697,2046,587378,467975,1055353
348,JHARKHAND,Kodarma,716259,390249,129677,130315,80561,52622,26415,20907,2374,442871,297992,740863
349,JHARKHAND,Giridih,2445474,1253475,503261,443980,261309,146464,77540,55122,8449,1496125,1047685,2543810
350,JHARKHAND,Deoghar,1492073,793538,217460,266292,190171,96331,54419,43979,6699,875351,635544,1510895
351,JHARKHAND,Godda,1313551,604519,217607,190777,126766,79430,47395,30870,4002,696847,653464,1350311
352,JHARKHAND,Sahibganj,1150567,483263,146399,171416,110822,52248,28087,19832,2593,531397,637296,1168693
353,JHARKHAND,Pakur,900422,352881,100367,133770,79045,29934,15700,9822,1525,370163,548434,918597
354,JHARKHAND,Dhanbad,2684487,1722204,317918,501453,449506,305054,186697,107382,14615,1882625,662522,2545147
355,JHARKHAND,Bokaro,2062330,1273520,242467,338861,342646,232434,154076,116396,21157,1448037,595924,2043961
356,JHARKHAND,Lohardaga,461790,259707,82873,84920,63545,38503,21987,13847,976,306651,188323,494974
357,JHARKHAND,Purbi Singhbhum,2293919,1507699,202047,346644,369670,278853,162210,157688,25048,1542160,525916,2068076
358,JHARKHAND,Palamu,1939869,1024563,303053,296937,231565,160964,100290,63595,7117,1163521,803424,1966945
359,JHARKHAND,Latehar,726978,350682,109491,121529,88787,46142,23885,13956,1017,404807,349277,754084
360,JHARKHAND,Hazaribagh,1734495,1013249,253962,322344,255576,173378,99945,79898,6512,1191615,613774,1805389
361,JHARKHAND,Ramgarh,949443,596497,115199,138748,134324,101381,70249,47207,5397,612505,292062,904567
362,JHARKHAND,Dumka,1321442,672409,229157,229259,149009,69525,38383,25593,2697,743623,601078,1344701
363,JHARKHAND,Jamtara,791042,426312,131150,132014,85745,40613,22995,14802,1578,428897,366012,794909
364,JHARKHAND,Ranchi,2914253,1911433,361522,547583,495515,370847,247237,195181,28424,2246309,613855,2860164
365,JHARKHAND,Khunti,531885,284575,64029,89730,89924,48591,20689,10130,537,323630,177856,501486
366,JHARKHAND,Gumla,1025213,559720,136719,242580,182260,82114,45613,23742,2913,715941,322119,1038060
367,JHARKHAND,Simdega,599578,343483,82317,130068,97580,47836,24842,13674,1197,397514,191341,588855
368,JHARKHAND,Pashchimi Singhbhum,1502338,727561,290007,461276,202752,79516,35824,10743,574,1080692,279016,1359708
369,JHARKHAND,Saraikela-Kharsawan,1065056,612993,134506,259984,177763,106348,49944,29840,1443,759828,228943,988771
370,ORISSA,Bargarh,1481255,983783,205253,310784,247014,147217,58840,49238,8133,1026479,442733,1469212
371,ORISSA,Jharsuguda,579505,405879,69122,101541,103622,70928,32909,22010,7932,408064,143508,551572
372,ORISSA,Sambalpur,1041099,703691,133005,185289,171876,108455,50705,45828,13071,708229,282248,990477
373,ORISSA,Debagarh,312520,197819,47615,58231,54088,27415,13420,9041,1729,211539,108811,320350
374,ORISSA,Sundargarh,2093437,1342322,208100,350349,335380,243386,120373,94710,36590,1388888,660465,2049353
375,ORISSA,Kendujhar,1801733,1052518,214518,287402,289350,158035,70059,57762,13918,1091044,700661,1791705
376,ORISSA,Mayurbhanj,2519738,1369397,283489,390037,385216,214921,92060,72847,17415,1455985,1094844,2550829
377,ORISSA,Baleshwar,2320529,1621232,342192,470502,416510,267354,112392,105962,27493,1742405,628627,2371032
378,ORISSA,Bhadrak,1506337,1094140,210736,391081,297270,177013,71815,67536,17449,1232900,323145,1556045
379,ORISSA,Kendrapara,1440361,1089265,218444,357621,298557,203472,76449,75926,12507,1242976,294723,1537699
380,ORISSA,Jagatsinghapur,1136971,889027,151737,251767,251332,185671,72703,70602,14001,997813,209984,1207797
381,ORISSA,Cuttack,2624470,2011469,289414,545514,513039,328319,159456,181601,45279,2062622,472182,2534804
382,ORISSA,Jajapur,1827192,1290455,261077,433653,330016,223657,96963,87623,19271,1452260,460953,1913213
383,ORISSA,Dhenkanal,1192811,829910,188872,238599,193395,132002,53162,43064,10903,859997,341887,1201884
384,ORISSA,Anugul,1273821,869456,180523,265782,204235,129226,58029,45588,16602,899985,347851,1247836
385,ORISSA,Nayagarh,962789,688362,174904,227102,177180,90089,36951,33148,5685,745059,232558,977617
386,ORISSA,Khordha,2251673,1749936,276378,445785,436534,295099,177974,247498,66645,1945913,371244,2317157
387,ORISSA,Puri,1698730,1291939,251520,413605,364098,179086,84374,87000,15511,1395194,309790,1704984
388,ORISSA,Ganjam,3529031,2210050,518072,767140,508511,297490,121151,97147,31266,2340777,1055331,3396108
389,ORISSA,Gajapati,577817,262537,68405,76419,54787,36977,17084,12556,1882,268110,335821,603931
390,ORISSA,Kandhamal,733110,399786,108606,145604,108773,48856,21351,14962,2462,450614,287948,738562
391,ORISSA,Baudh,441162,271612,74205,98316,67549,30799,12500,8124,1683,293176,146392,439568
392,ORISSA,Subarnapur,610183,398421,86120,139994,105846,65368,25556,16745,4881,444510,167244,611754
393,ORISSA,Balangir,1648997,927260,240180,298288,226728,116297,54694,42401,6810,985398,721389,1706787
394,ORISSA,Nuapada,610382,299383,64389,114394,73787,51886,19577,10131,4316,338480,316086,654566
395,ORISSA,Kalahandi,1576869,802036,213426,225468,172905,94044,40383,27385,6840,780451,765368,1545819
396,ORISSA,Rayagada,967911,407735,84956,97387,73210,46001,21439,17681,6306,346980,583140,930120
397,ORISSA,Nabarangapur,1220946,470379,116468,155611,95988,44522,16463,11198,2282,442532,739190,1181722
398,ORISSA,Koraput,1379647,568090,158847,158653,98266,60589,32257,29000,10200,547812,770707,1318519
399,ORISSA,Malkangiri,613192,244706,60913,64683,44962,19031,8487,5585,1202,204863,390356,595219
400,CHHATTISGARH,Koriya,658917,397823,143413,109639,87969,47127,38677,26802,4134,457761,179639,637400
401,CHHATTISGARH,Surguja,2359886,1187941,364452,338509,281260,135374,105992,64607,9524,1299718,991866,2291584
402,CHHATTISGARH,Jashpur,851669,495415,120768,137681,127299,64188,50562,26161,3166,529825,328438,858263
403,CHHATTISGARH,Raigarh,1493984,951639,246480,260661,210964,130700,93340,66358,8804,1017307,460166,1477473
404,CHHATTISGARH,Korba,1206640,748759,178191,188303,168387,89167,83166,61215,11792,780221,410186,1190407
405,CHHATTISGARH,Janjgir - Champa,1619707,1019634,257020,241692,241761,152183,127543,58712,7630,1086541,587734,1674275
406,CHHATTISGARH,Bilaspur,2663629,1596560,382091,407692,337793,189296,152838,134637,19654,1624001,943112,2567113
407,CHHATTISGARH,Kabeerdham,822526,414167,126806,123840,84147,37650,28074,16671,1679,418867,376852,795719
408,CHHATTISGARH,Rajnandgaon,1537133,1008379,263447,287436,267653,105149,82141,51698,5340,1062864,467554,1530418
409,CHHATTISGARH,Durg,3343872,2303378,463598,573291,497668,309508,286244,202424,30555,2363288,823501,3186789
410,CHHATTISGARH,Raipur,4063872,2629749,618508,664470,552373,313247,267265,227382,31483,2674728,1247434,3922162
411,CHHATTISGARH,Mahasamund,1032754,637963,179770,194739,152183,78583,57949,33357,5951,702532,384764,1087296
412,CHHATTISGARH,Dhamtari,799781,546833,143128,148544,120146,65196,58875,31319,5096,572304,214637,786941
413,CHHATTISGARH,Uttar Bastar Kanker,748941,456042,135206,124893,100674,47002,43956,21410,1658,474799,243039,717838
414,CHHATTISGARH,Bastar,1413199,650863,183667,178766,139330,60936,57413,32895,3227,656234,729550,1385784
415,CHHATTISGARH,Narayanpur,139820,56621,16980,16034,9513,4158,4488,2216,268,53657,78331,131988
416,CHHATTISGARH,Dakshin Bastar Dantewada,533638,191237,40079,39023,27720,16665,16905,11197,1372,152961,336963,489924
417,CHHATTISGARH,Bijapur,255230,86919,25597,22787,14170,7192,6755,3421,147,80069,163278,243347
418,MADHYA PRADESH,Sheopur,687861,328025,90911,70840,43009,37072,24732,17091,1497,285152,393141,678293
419,MADHYA PRADESH,Morena,1965970,1179685,288979,285682,228234,170254,115790,71005,8265,1168209,706917,1875126
420,MADHYA PRADESH,Bhind,1703005,1094917,202629,261162,199044,140743,96011,50222,8059,957870,388473,1346343
421,MADHYA PRADESH,Gwalior,2032036,1357210,235648,235924,204871,193082,166719,193947,23148,1253339,554486,1807825
422,MADHYA PRADESH,Datia,786754,491445,132176,131372,88949,73398,48978,34853,4262,513988,260076,774064
423,MADHYA PRADESH,Shivpuri,1726050,900846,261087,214162,125117,84684,58509,44812,6218,794589,719547,1514136
424,MADHYA PRADESH,Tikamgarh,1445166,747940,202448,188694,143231,78053,58245,35034,5340,711045,659348,1370393
425,MADHYA PRADESH,Chhatarpur,1762375,943033,270951,236054,160310,112961,77787,59704,7837,925604,770268,1695872
426,MADHYA PRADESH,Panna,1016520,552559,171707,134936,99251,70359,47903,29795,3052,557003,427997,985000
427,MADHYA PRADESH,Sagar,2378458,1545719,347752,426916,297079,214137,137899,116753,14346,1554882,711804,2266686
428,MADHYA PRADESH,Damoh,1264219,747715,197917,217296,150040,95032,64414,41158,5260,771117,469038,1240155
429,MADHYA PRADESH,Satna,2228935,1371781,338947,334635,309536,197373,148091,105499,16052,1450133,715509,2165642
430,MADHYA PRADESH,Rewa,2365106,1441757,344362,330131,312931,206274,180635,122371,11438,1508142,766166,2274308
431,MADHYA PRADESH,Umaria,644758,356672,90791,94011,74854,43418,27216,18144,2784,351218,230782,582000
432,MADHYA PRADESH,Neemuch,826067,508834,137656,127167,83189,69134,53465,42343,6119,519073,289113,808186
433,MADHYA PRADESH,Mandsaur,1340411,834591,244891,217234,149219,109751,77219,52546,4956,855816,467002,1322818
434,MADHYA PRADESH,Ratlam,1455069,825880,224715,194131,129392,111461,86507,67192,5868,819266,622153,1441419
435,MADHYA PRADESH,Ujjain,1986864,1240990,286534,280030,178295,159263,119586,111290,13282,1148280,659279,1807559
436,MADHYA PRADESH,Shajapur,1512681,894612,271215,239081,141225,111366,75967,48671,3391,890916,544791,1435707
437,MADHYA PRADESH,Dewas,1563715,925369,242508,225380,149522,125772,94403,55383,4991,897959,565365,1463324
438,MADHYA PRADESH,Dhar,2185793,1077338,262090,244058,164576,134279,99882,66721,6543,978149,1021851,2000000
439,MADHYA PRADESH,Indore,3276697,2309130,428413,472233,384611,362209,300076,382658,36326,2366526,718174,3084700
440,MADHYA PRADESH,Khargone (West Nimar),1873046,986234,287410,256930,152267,114246,89581,64150,5291,969875,932619,1902494
441,MADHYA PRADESH,Barwani,1385881,549926,157337,137116,74067,59100,42649,30754,2581,503604,825034,1328638
442,MADHYA PRADESH,Rajgarh,1545814,804245,239738,174381,103464,96386,72316,51499,4799,742583,706958,1449541
443,MADHYA PRADESH,Vidisha,1458875,862918,242021,214603,123650,104007,65581,59814,6780,816456,512311,1328767
444,MADHYA PRADESH,Bhopal,2371061,1660690,229082,303171,287198,211371,178165,266618,30845,1506450,462581,1969031
445,MADHYA PRADESH,Sehore,1311332,780362,193885,179388,136284,120687,77541,50655,6755,765195,508396,1273591
446,MADHYA PRADESH,Raisen,1331597,820220,237981,210402,144108,117908,69419,48384,4607,832809,444877,1277686
447,MADHYA PRADESH,Betul,1575362,939769,239114,232532,176325,140402,105696,82761,5876,982706,603098,1585804
448,MADHYA PRADESH,Harda,570465,352550,90059,87733,60757,46556,31939,27126,3469,347639,177731,525370
449,MADHYA PRADESH,Hoshangabad,1241350,810644,159703,183156,145076,119682,89589,84769,9279,791254,344492,1135746
450,MADHYA PRADESH,Katni,1292042,790773,198447,207366,161727,112242,80935,53578,6658,820953,465374,1286327
451,MADHYA PRADESH,Jabalpur,2463289,1756468,267932,352284,313910,268333,222987,235072,24872,1685390,540029,2225419
452,MADHYA PRADESH,Narsimhapur,1091854,718785,160765,180070,128758,109996,82020,52763,5802,720174,356987,1077161
453,MADHYA PRADESH,Dindori,704524,378714,103002,113875,84065,49277,31104,15179,1674,398176,295655,693831
454,MADHYA PRADESH,Mandla,1054905,604962,156711,170994,115632,82166,58066,35476,4587,623632,376944,1000576
455,MADHYA PRADESH,Chhindwara,2090922,1294198,284113,336391,225747,215098,167946,112383,12141,1353819,663446,2017265
456,MADHYA PRADESH,Seoni,1379131,864194,223650,241327,151636,116124,84398,55984,6427,879546,458811,1338357
457,MADHYA PRADESH,Balaghat,1701698,1147623,290699,312640,235251,168635,126308,74213,7414,1215160,493415,1708575
458,MADHYA PRADESH,Guna,1241519,653980,197902,157141,84560,79924,50724,42147,6451,618849,578034,1196883
459,MADHYA PRADESH,Ashoknagar,845071,469109,148647,117053,62802,51499,29551,22791,3466,435809,359525,795334
460,MADHYA PRADESH,Shahdol,1066063,604194,161972,154282,128427,80402,60915,46513,5352,637863,422736,1060599
461,MADHYA PRADESH,Anuppur,749237,436595,113208,115716,93450,58536,42743,31646,3066,458365,271733,730098
462,MADHYA PRADESH,Sidhi,1127033,600785,185550,168224,129344,80312,60845,33067,3896,661238,477472,1138710
463,MADHYA PRADESH,Singrauli,1178273,585054,189929,150446,103971,61089,42434,30597,7449,585915,517447,1103362
464,MADHYA PRADESH,Jhabua,1025048,352081,98308,79781,40466,38236,28990,20240,1973,307994,775664,1083658
465,MADHYA PRADESH,Alirajpur,728999,209754,43866,44457,22410,18213,15358,10040,1028,155372,658684,814056
466,MADHYA PRADESH,Khandwa (East Nimar),1310061,731615,203486,201537,115166,77010,56847,42771,4970,701787,551824,1253611
467,MADHYA PRADESH,Burhanpur,757847,408679,107547,119468,69765,57058,42618,28237,4761,429454,317962,747416
468,GUJARAT,Kachchh,2092371,1252319,246956,469402,141345,157284,61366,60386,14062,1150801,581952,1732753
469,GUJARAT,Banas Kantha,3120506,1704923,366867,859436,159433,226765,105372,66950,14451,1799274,1207376,3006650
470,GUJARAT,Patan,1343734,837913,168990,364667,78731,129584,57494,46355,11111,856932,452891,1309823
471,GUJARAT,Mahesana,2035064,1502645,260278,467128,183468,266108,139208,130723,27391,1474304,434497,1908801
472,GUJARAT,Sabar Kantha,2428589,1578734,214062,597667,211423,333650,198963,110817,24745,1691327,665058,2356385
473,GUJARAT,Gandhinagar,1391753,1030494,136131,363156,133594,196456,95730,108400,16088,1049555,246993,1296548
474,GUJARAT,Ahmadabad,7214225,5435760,761358,1614370,805199,1135058,549188,839295,100831,5805299,1129562,6934861
475,GUJARAT,Surendranagar,1756268,1093626,234873,482679,165406,172947,61164,58389,14501,1189959,493427,1683386
476,GUJARAT,Rajkot,3804558,2725056,383780,913928,402240,540278,204306,266295,29924,2740751,738660,3479411
477,GUJARAT,Jamnagar,2160119,1396534,255785,491009,194057,199634,74029,87523,18573,1320610,502873,1823483
478,GUJARAT,Porbandar,585449,393678,50588,150643,71637,63458,25119,22458,5260,389163,137119,526282
479,GUJARAT,Junagadh,2743082,1842818,271762,700258,294811,311849,137505,139957,30127,1886269,669022,2555291
480,GUJARAT,Amreli,1514190,995459,230474,412251,120625,149478,66785,50999,8582,1039194,380595,1419789
481,GUJARAT,Bhavnagar,2880365,1887255,422461,929286,266953,281250,96241,93391,13946,2103528,508664,2612192
482,GUJARAT,Anand,2092745,1551253,257524,560542,229013,283571,127459,110351,20487,1588947,360506,1949453
483,GUJARAT,Kheda,2299885,1660243,295057,641541,250044,310341,148530,84223,19498,1749234,482078,2231312
484,GUJARAT,Panch Mahals,2390776,1440805,255905,601358,205420,283648,139773,71810,17958,1575872,781582,2357454
485,GUJARAT,Dohad,2127086,1007171,214098,392739,114168,156556,95794,41458,9656,1024469,1047088,2071557
486,GUJARAT,Vadodara,4165626,2893080,396624,865726,457662,504732,268451,314960,60177,2868332,910219,3778551
487,GUJARAT,Narmada,590297,370336,76197,146661,58188,52687,28396,14748,3451,380328,192780,573108
488,GUJARAT,Bharuch,1551019,1118276,161675,367060,164765,188539,83895,74380,16036,1056350,273829,1330179
489,GUJARAT,The Dangs,228291,140968,43639,59954,17736,14872,7560,3490,2215,149466,91160,240626
490,GUJARAT,Navsari,1329672,1001909,145678,266733,140235,190861,112460,85041,26012,967020,261956,1228976
491,GUJARAT,Valsad,1705678,1170657,165459,303197,171712,212318,123281,90912,26987,1093866,405928,1499794
492,GUJARAT,Surat,6081322,4571410,566242,1332690,807021,896927,433651,379505,79862,4495898,942150,5438048
493,GUJARAT,Tapi,807022,490036,84559,174139,75545,86580,49482,31743,8767,510815,292102,802917
494,DAMAN AND DIU,Diu,52074,38058,1872,7668,8545,9051,4367,1906,635,34044,10735,44779
495,DAMAN AND DIU,Daman,191173,150348,8957,28094,30406,26991,14170,9128,1995,119741,20641,140382
497,MAHARASHTRA,Nandurbar,1648295,906509,166664,218718,121404,160961,113019,58461,9248,848475,790613,1639088
498,MAHARASHTRA,Dhule,2050862,1293916,200494,323641,208571,290656,182739,114931,14526,1335558,649568,1985126
499,MAHARASHTRA,Jalgaon,4229917,2891882,482462,735730,532587,627198,375643,229987,31008,3014615,1003050,4017665
500,MAHARASHTRA,Buldana,2586258,1879874,315408,457067,400342,406379,228266,113783,19619,1940864,600436,2541300
501,MAHARASHTRA,Akola,1813906,1411281,231841,328367,275264,291391,205723,112574,15157,1460317,352687,1813004
502,MAHARASHTRA,Washim,1197160,869917,166509,238985,160331,162762,116032,47865,7294,899778,291525,1191303
503,MAHARASHTRA,Amravati,2888445,2251875,326195,468853,463051,525116,346876,203273,16148,2349512,478074,2827586
504,MAHARASHTRA,Wardha,1300774,1019458,140470,186781,201471,225208,158055,93772,7017,1012774,212054,1224828
505,MAHARASHTRA,Nagpur,4653570,3673808,325084,666693,812381,790443,542228,493236,73475,3703540,601547,4305087
506,MAHARASHTRA,Bhandara,1200334,899860,115150,187870,208902,204435,153749,67061,12452,949619,235524,1185143
507,MAHARASHTRA,Gondiya,1322507,1004243,138457,237888,231153,225595,159570,57923,9620,1060206,256549,1316755
508,MAHARASHTRA,Gadchiroli,1072942,708365,108850,145767,139482,140345,95911,35809,4154,670318,360229,1030547
509,MAHARASHTRA,Chandrapur,2204307,1578615,243773,316192,337320,351610,241179,126488,15040,1631602,516728,2148330
510,MAHARASHTRA,Yavatmal,2772348,2022574,391944,562739,382001,389924,245819,123074,21889,2117390,718204,2835594
511,MAHARASHTRA,Nanded,3361292,2189425,416869,691348,368723,416761,255650,156225,21729,2327305,884626,3211931
512,MAHARASHTRA,Hingoli,1177345,790743,175736,266649,127246,136075,74544,38698,5932,824880,331388,1156268
513,MAHARASHTRA,Parbhani,1836086,1157814,229217,396713,204316,229103,116041,81333,9703,1266426,552643,1819069
514,MAHARASHTRA,Jalna,1959046,1195523,271061,422207,218189,225331,120715,64060,9724,1331287,545980,1877267
515,MAHARASHTRA,Aurangabad,3701282,2503837,381695,686271,422964,537936,310762,253253,19101,2611982,819734,3431716
516,MAHARASHTRA,Nashik,6107187,4345366,544346,1038955,851714,830070,485052,373100,97219,4220456,1481778,5702234
517,MAHARASHTRA,Thane,11060148,8227161,712171,1530916,1588196,1751284,1080597,961719,114453,7739336,1692022,9431358
518,MAHARASHTRA,Mumbai Suburban,9356962,7575485,512268,1140066,1628031,1914168,1091433,1183117,189063,7658146,1111093,8769239
519,MAHARASHTRA,Mumbai,3085411,2509022,118967,399792,603937,665263,378764,343374,57044,2567141,262312,2829453
520,MAHARASHTRA,Raigarh,2634200,1939994,231263,407662,335886,441072,221410,204507,19940,1861740,482420,2344160
521,MAHARASHTRA,Pune,9429408,7171723,559840,1234549,1383055,1414563,867256,1086650,190336,6736249,1353077,8089326
522,MAHARASHTRA,Ahmadnagar,4543159,3151890,483996,833691,580959,745895,411908,315842,32304,3404595,1061271,4465866
523,MAHARASHTRA,Bid,2585049,1718507,309704,436446,280800,316758,206530,129996,11438,1691672,821607,2513279
524,MAHARASHTRA,Latur,2454196,1650672,268627,423711,296910,380344,224998,153256,18106,1765952,596213,2362165
525,MAHARASHTRA,Osmanabad,1657576,1137810,183972,300965,201646,260772,139479,96847,9913,1193594,440363,1633957
526,MAHARASHTRA,Solapur,4317756,2910676,390337,788150,535848,643327,328020,236302,29051,2951035,976795,3927830
527,MAHARASHTRA,Satara,3003741,2225694,288427,495822,407977,556706,299993,243457,20884,2313266,545423,2858689
528,MAHARASHTRA,Ratnagiri,1615069,1199392,163025,378554,269872,247257,111600,65700,15429,1251437,319622,1571059
529,MAHARASHTRA,Sindhudurg,849651,666067,86480,165284,134734,175070,89023,48418,3451,702460,121922,824382
530,MAHARASHTRA,Kolhapur,3876001,2825845,321457,622362,487227,698604,395234,335413,40828,2901125,778000,3679125
531,MAHARASHTRA,Sangli,2822143,2049467,208511,507318,459156,453404,244804,214003,36983,2124179,579039,2703218
532,ANDHRA PRADESH,Adilabad,2741239,1483347,232470,344167,281752,225957,143143,100226,19277,1346992,1030640,2377632
533,ANDHRA PRADESH,Nizamabad,2551335,1389810,269487,421399,338668,396396,223365,141850,13382,1804547,1041862,2846409
534,ANDHRA PRADESH,Karimnagar,3776269,2206829,340372,453505,482842,463403,293493,256633,35312,2325560,1280393,3605953
535,ANDHRA PRADESH,Medak,3033288,1637137,324267,503713,481984,373729,201928,127493,16466,2029580,1199818,3229398
536,ANDHRA PRADESH,Hyderabad,3943323,2892155,230962,596591,685215,811501,517425,558090,45937,3445721,556902,4002623
537,ANDHRA PRADESH,Rangareddy,5296741,3538028,457916,756588,809283,821821,598940,740896,57436,4242880,1158473,5401353
538,ANDHRA PRADESH,Mahbubnagar,4053028,1940646,419379,596134,441585,308575,169083,98227,16121,2049104,1604319,3653423
539,ANDHRA PRADESH,Nalgonda,3488809,2001019,369537,518669,471233,367424,238695,196134,27003,2188695,1294811,3483506
540,ANDHRA PRADESH,Warangal,3512576,2065023,314252,457529,454322,430242,279234,248942,27663,2212184,1191252,3403436
541,ANDHRA PRADESH,Khammam,2797370,1630234,295639,346118,329630,238811,154774,160804,25456,1551232,875272,2426504
542,ANDHRA PRADESH,Srikakulam,2703114,1495381,291793,348354,319244,251521,146721,121213,21031,1499877,1009992,2509869
543,ANDHRA PRADESH,Vizianagaram,2344474,1238388,250446,300057,257468,186576,115144,103591,27041,1240323,1031683,2272006
544,ANDHRA PRADESH,Visakhapatnam,4290589,2568249,414636,568178,649271,541942,329770,289734,44164,2837695,1418851,4256546
545,ANDHRA PRADESH,East Godavari,5154296,3288577,669420,947606,797497,521562,271809,263023,47702,3518619,1524603,5043222
546,ANDHRA PRADESH,West Godavari,3936966,2652389,595331,718960,585595,415178,215863,207586,33329,2771842,1028767,3800609
547,ANDHRA PRADESH,Krishna,4517398,3009718,618101,692968,630603,531821,312753,328454,54728,3169428,1352499,4521927
548,ANDHRA PRADESH,Guntur,4887813,2960441,736270,845810,674957,453446,246580,221924,30279,3209266,1474349,4683615
549,ANDHRA PRADESH,Prakasam,3397448,1904435,489805,495556,368919,249034,142026,133627,21976,1900943,1218310,3119253
551,ANDHRA PRADESH,Y.S.R.,2882469,1716766,408650,509166,413364,258798,140145,116330,16231,1862684,893657,2756341
552,ANDHRA PRADESH,Kurnool,4053463,2127161,521327,672951,466940,271828,152453,115504,19282,2220285,1517933,3738218
553,ANDHRA PRADESH,Anantapur,4081148,2310960,462273,720357,582075,331793,162175,144915,23341,2426929,1369069,3795998
554,ANDHRA PRADESH,Chittoor,4174064,2667878,522961,770836,673197,548336,265199,246409,36017,3062955,1170993,4233948
555,KARNATAKA,Belgaum,4779661,3052032,544564,1057297,609600,532584,279583,201884,56621,3282133,1346776,4628909
556,KARNATAKA,Bagalkot,1889752,1113412,242336,385986,147397,171505,115095,82319,25791,1170429,608843,1779272
557,KARNATAKA,Bijapur,2177331,1248268,246391,430477,143199,182756,129109,96990,24569,1253491,746979,2000470
558,KARNATAKA,Bidar,1703300,1042673,188998,474921,194233,181076,105347,54900,12885,1212360,515395,1727755
559,KARNATAKA,Raichur,1928812,979769,147743,385673,163709,153346,82082,50463,14622,997638,783126,1780764
560,KARNATAKA,Koppal,1389920,809085,222140,357098,127605,113028,72243,43967,10431,946512,472182,1418694
561,KARNATAKA,Gadag,1064570,700177,121615,244640,112703,105150,63816,42053,12822,702799,306138,1008937
562,KARNATAKA,Dharwad,1847023,1301664,252596,383041,185530,227113,143453,137768,34302,1363803,428556,1792359
563,KARNATAKA,Uttara Kannada,1437169,1081906,198632,338390,183534,210270,108521,94767,22876,1156990,277857,1434847
564,KARNATAKA,Haveri,1597668,1085443,240925,430529,201965,158442,84357,55310,16830,1188358,383494,1571852
565,KARNATAKA,Bellary,2452595,1421621,275785,529576,219702,203139,121453,89475,29367,1468497,787762,2256259
566,KARNATAKA,Chitradurga,1659456,1087392,188329,332648,196470,217567,132435,75262,22078,1164789,452975,1617764
567,KARNATAKA,Davanagere,1945497,1308540,242130,446793,206686,269748,154781,123863,32375,1476376,467414,1943790
568,KARNATAKA,Shimoga,1752753,1263016,191641,385978,292481,251095,132138,111753,18036,1383122,355222,1738344
569,KARNATAKA,Udupi,1177361,926429,142493,286193,176260,178094,109663,107279,18444,1018426,204028,1222454
570,KARNATAKA,Chikmagalur,1137961,818345,114570,257550,160083,177585,96470,72420,12631,891309,204371,1095680
571,KARNATAKA,Tumkur,2678980,1813391,270373,500593,386998,423738,213588,143735,30687,1969712,686274,2655986
572,KARNATAKA,Bangalore,9621551,7512276,599794,1509693,1629870,2018079,1196965,1733274,198399,8886074,1304048,10190122
573,KARNATAKA,Mandya,1805769,1149649,145178,309476,226552,308624,157839,102838,19987,1270494,504734,1775228
574,KARNATAKA,Hassan,1776421,1225256,182255,354480,232531,292369,147837,103152,27774,1340398,401227,1741625
575,KARNATAKA,Dakshina Kannada,2089649,1666323,191317,520715,296110,309141,178989,185916,36295,1718483,298846,2017329
576,KARNATAKA,Kodagu,554519,412877,51287,111562,75291,86232,54939,43225,8251,430787,91352,522139
577,KARNATAKA,Mysore,3001127,1962180,207091,537686,404565,452412,222230,212541,26834,2063359,747237,2810596
578,KARNATAKA,Chamarajanagar,1020791,565279,82487,204765,132421,109361,57053,34799,9600,630486,401643,1032129
579,KARNATAKA,Gulbarga,2566326,1427368,177860,579057,270622,290570,153746,104256,20492,1596603,883704,2480307
580,KARNATAKA,Yadgir,1174271,510003,98481,204926,77942,73599,40104,27728,4634,527414,579042,1106456
581,KARNATAKA,Kolar,1536401,1016219,138015,289841,228422,225498,107929,71422,17961,1079088,399089,1478177
582,KARNATAKA,Chikkaballapura,1255104,783222,100059,219778,193549,187040,80928,55056,6631,843041,380402,1223443
583,KARNATAKA,Bangalore Rural,990923,688749,100770,168165,126285,166677,82235,51015,10741,705888,205062,910950
584,KARNATAKA,Ramanagara,1082636,674758,98447,187673,119218,155358,77233,46318,8802,693049,324721,1017770
585,GOA,North Goa,818008,663060,40968,101521,148792,153887,87513,86781,16601,636063,99538,735601
586,GOA,South Goa,640537,502427,29874,73039,119869,108989,64786,57460,9579,463596,88577,552173
587,LAKSHADWEEP,Lakshadweep,64473,52553,5641,13391,13836,13997,6642,3491,1059,58057,5953,64010
588,KERALA,Kasaragod,1307375,1037492,115476,268084,230416,238900,122657,76192,16585,1068310,212905,1281215
589,KERALA,Kannur,2523003,2138434,204713,487016,491844,540383,308670,217203,40277,2290106,279352,2569458
590,KERALA,Wayanad,817420,645585,65326,144896,137227,184266,87042,51111,8786,678654,131211,809865
591,KERALA,Kozhikode,3086293,2615443,247996,564392,647221,630818,351267,250117,53166,2744977,335520,3080497
592,KERALA,Malappuram,4112920,3311315,415601,770417,814285,933793,392867,203779,41344,3572086,622345,4194431
593,KERALA,Palakkad,2809934,2239492,249198,492864,608176,572412,232109,180540,36370,2371669,439934,2811603
594,KERALA,Thrissur,3121200,2678548,222627,445696,524387,821831,362657,338600,71535,2787333,307665,3094998
595,KERALA,Ernakulam,3282388,2855676,212263,446380,554817,702511,389793,429880,113133,2848777,268315,3117092
596,KERALA,Idukki,1108974,923010,79149,166604,209398,261237,136428,86136,19252,958204,126589,1084793
597,KERALA,Kottayam,1974551,1749798,117681,271496,373998,475724,280720,221350,52339,1793308,134393,1927701
598,KERALA,Alappuzha,2127789,1852797,133039,334339,418953,573306,274789,198858,58096,1991380,163991,2155371
599,KERALA,Pathanamthitta,1197412,1062553,64054,146138,202197,371128,172884,123549,32477,1112427,71053,1183480
600,KERALA,Kollam,2635375,2240273,172247,406592,562529,595191,307950,233402,64052,2341963,231286,2573249
601,KERALA,Thiruvananthapuram,3301427,2785408,206328,460690,642470,682156,389161,381782,76129,2838716,309042,3147758
602,TAMIL NADU,Thiruvallur,3728104,2791721,181452,461918,600731,622789,303091,451321,66378,2687680,610048,3297728
603,TAMIL NADU,Chennai,4646732,3776276,167207,516445,720331,801050,464207,905515,67277,3642032,419065,4061097
604,TAMIL NADU,Kancheepuram,3998252,3013382,183054,535947,608188,634172,312208,526886,67354,2867809,678374,3546183
605,TAMIL NADU,Vellore,3936331,2773928,191963,721473,719731,641585,311434,308514,71127,2965827,891430,3857257
606,TAMIL NADU,Tiruvannamalai,2464875,1626813,203879,442688,423135,343955,174560,158041,36454,1782712,672427,2455139
607,TAMIL NADU,Viluppuram,3458873,2195776,202930,646306,549742,508930,246856,229726,45680,2430170,999902,3430072
608,TAMIL NADU,Salem,3482056,2285562,188672,571061,518763,457866,242306,296399,60365,2335432,955045,3290477
609,TAMIL NADU,Namakkal,1726601,1176131,123573,297179,247516,214836,126468,169206,21582,1200360,388418,1588778
610,TAMIL NADU,Erode,2251744,1492662,175017,345914,319484,269016,155344,215514,30391,1510680,608003,2118683
611,TAMIL NADU,The Nilgiris,735394,569647,47555,122821,130678,133569,76132,69657,8328,588740,114497,703237
612,TAMIL NADU,Dindigul,2159775,1481834,207751,386421,372636,282628,153100,163050,29443,1595029,480681,2075710
613,TAMIL NADU,Karur,1064493,727044,76629,190229,167466,146666,77874,85595,14951,759410,276930,1036340
614,TAMIL NADU,Tiruchirappalli,2722290,2038981,229415,444023,447474,418930,223178,291506,70392,2124918,401149,2526067
615,TAMIL NADU,Perambalur,565223,375823,85210,106751,85101,71650,41447,44025,9189,443373,109011,552384
616,TAMIL NADU,Ariyalur,754894,480604,60697,134123,113437,96860,53934,57524,16126,532701,233438,766139
617,TAMIL NADU,Cuddalore,2605914,1815281,169844,412237,418769,386652,186394,227530,67411,1868837,634041,2502878
618,TAMIL NADU,Nagapattinam,1616450,1213008,136593,323359,313357,249630,122350,125639,35762,1306690,253572,1560262
619,TAMIL NADU,Thiruvarur,1264277,946471,138960,250163,243773,203450,103908,99082,28166,1067502,175564,1243066
620,TAMIL NADU,Thanjavur,2405890,1790998,138375,431983,419605,373111,178126,222410,49261,1812871,461123,2273994
621,TAMIL NADU,Pudukkottai,1618345,1110545,97231,283299,270046,251855,121706,111731,31315,1167183,447346,1614529
622,TAMIL NADU,Sivaganga,1339101,959744,101778,216931,236700,199263,103903,115894,23941,998410,311112,1309522
623,TAMIL NADU,Madurai,3038252,2273430,234611,525151,532616,453509,250285,363152,39350,2398674,449125,2847799
624,TAMIL NADU,Theni,1245899,870080,90590,219747,213496,156676,95231,101147,14674,891561,270738,1162299
625,TAMIL NADU,Virudhunagar,1942288,1398788,163264,398670,317054,230321,138306,167506,35156,1450277,403246,1853523
626,TAMIL NADU,Ramanathapuram,1353445,978946,246909,293886,236511,189132,105978,97405,16785,1186606,107292,1293898
627,TAMIL NADU,Thoothukkudi,1750176,1349697,153922,372036,315817,227154,133010,155613,31525,1389077,265032,1654109
628,TAMIL NADU,Tirunelveli,3077233,2273457,263517,618656,517646,390495,220088,247635,71437,2329474,621010,2950484
629,TAMIL NADU,Kanniyakumari,1870374,1548738,134236,331559,314029,322511,226312,254107,43034,1625788,210901,1836689
630,TAMIL NADU,Dharmapuri,1506843,917709,129778,240222,221194,177877,103367,112592,26069,1011099,512824,1523923
631,TAMIL NADU,Krishnagiri,1879809,1187958,135813,290351,289026,276694,133744,137081,24128,1286837,578724,1865561
632,TAMIL NADU,Coimbatore,3458045,2635907,220388,466745,523563,526165,273098,440520,53709,2504188,519919,3024107
633,TAMIL NADU,Tiruppur,2479052,1760566,192583,444390,369432,298635,170870,179733,21436,1677079,552447,2229526
634,PONDICHERRY,Yanam,55626,39274,3804,10954,8806,8044,4101,3836,1315,40860,14923,55783
635,PONDICHERRY,PONDICHERRY,950289,726649,61364,127754,150478,152482,81519,134067,17367,725031,146861,871892
636,PONDICHERRY,Mahe,41816,36470,2948,6043,7930,8773,5711,4475,978,36858,2993,39851
637,PONDICHERRY,Karaikal,200222,154916,18943,32899,33458,29456,15930,18998,4877,154561,32717,187278
