State_name,District_name,Literate,Female_Literate,Male_Literate,Population,Graduate_Education,Illiterate_Education
JAMMU AND KASHMIR,Kupwara,439654,156831,282823,870354,21751,289765
JAMMU AND KASHMIR,Badgam,335649,127908,207741,753745,27950,342646
JAMMU AND KASHMIR,Leh(Ladakh),93770,30936,62834,133487,6197,32637
JAMMU AND KASHMIR,Kargil,86236,29935,56301,140802,3077,39854
JAMMU AND KASHMIR,Punch,261724,98391,163333,476835,13962,164044
JAMMU AND KASHMIR,Rajouri,364109,139640,224469,642415,18576,242306
JAMMU AND KASHMIR,Kathua,389204,160705,228499,616435,24330,181297
JAMMU AND KASHMIR,Baramula,545149,207979,337170,1008039,48285,350119
JAMMU AND KASHMIR,Bandipore,185979,68921,117058,392232,12721,163648
JAMMU AND KASHMIR,Srinagar,748584,316838,431746,1236829,121856,310225
JAMMU AND KASHMIR,Ganderbal,143276,52695,90581,297446,9633,116734
JAMMU AND KASHMIR,Pulwama,293958,115632,178326,560440,31286,190369
JAMMU AND KASHMIR,Shupiyan,136500,56145,80355,266215,10782,107053
JAMMU AND KASHMIR,Anantnag,545532,221115,324417,1078692,41570,337265
JAMMU AND KASHMIR,Kulgam,209085,84033,125052,424483,18240,175199
JAMMU AND KASHMIR,Doda,219083,80463,138620,409936,12647,163565
JAMMU AND KASHMIR,Ramban,124065,41127,82938,283713,4923,141812
JAMMU AND KASHMIR,Kishtwar,107506,38806,68700,230696,5438,101166
JAMMU AND KASHMIR,Udhampur,322354,124811,197543,554985,17345,194838
JAMMU AND KASHMIR,Reasi,150542,56605,93937,314667,4733,143293
JAMMU AND KASHMIR,Jammu,1137135,495219,641916,1529958,146501,268279
JAMMU AND KASHMIR,Samba,228139,97827,130312,318898,14055,65643
HIMACHAL PRADESH,Chamba,323842,137778,186064,519080,15506,154575
HIMACHAL PRADESH,Kangra,1152640,546197,606443,1510075,91236,271892
HIMACHAL PRADESH,Lahul AND Spiti,21845,8948,12897,31564,2378,6515
HIMACHAL PRADESH,Kullu,307672,133122,174550,437903,23168,103136
HIMACHAL PRADESH,Mandi,723747,330078,393669,999777,54139,218570
HIMACHAL PRADESH,Hamirpur,358091,177536,180555,454768,35620,72551
HIMACHAL PRADESH,Una,399715,186434,213281,521173,32120,87735
HIMACHAL PRADESH,Bilaspur,287620,132021,155599,381956,25474,65864
HIMACHAL PRADESH,Solan,428578,184206,244372,580320,36803,104084
HIMACHAL PRADESH,Sirmaur,362645,157028,205617,529855,23352,140486
HIMACHAL PRADESH,Shimla,612642,269796,342846,814010,80414,137576
HIMACHAL PRADESH,Kinnaur,60699,24002,36697,84121,5118,16944
PUNJAB,Gurdaspur,1634719,727059,907660,2298323,104345,478020
PUNJAB,Kapurthala,576567,260313,316254,815168,48221,174995
PUNJAB,Jalandhar,1622537,739956,882581,2193590,162965,387809
PUNJAB,Hoshiarpur,1199699,561772,637927,1586625,93618,294723
PUNJAB,Shahid Bhagat Singh Nagar,438459,199304,239155,612310,26893,133275
PUNJAB,Fatehgarh Sahib,426033,187337,238696,600163,34990,142314
PUNJAB,Ludhiana,2560225,1131877,1428348,3498739,272280,631980
PUNJAB,Moga,627889,279340,348549,995746,37417,306336
PUNJAB,Firozpur,1227511,520441,707070,2029074,82448,714869
PUNJAB,Muktsar,524848,224447,300401,901896,36905,340886
PUNJAB,Faridkot,381285,165518,215767,617508,29838,204895
PUNJAB,Bathinda,844868,356607,488261,1388525,70240,438529
PUNJAB,Mansa,423560,179523,244037,769751,27461,311513
PUNJAB,Patiala,1266791,555739,711052,1895686,141947,518772
PUNJAB,Amritsar,1684770,751789,932981,2490656,142399,540010
PUNJAB,Tarn Taran,666162,289735,376427,1119627,21322,381879
PUNJAB,Rupnagar,502731,224197,278534,684627,38823,124100
PUNJAB,Sahibzada Ajit Singh Nagar,736575,326631,409944,994628,105306,172226
PUNJAB,Sangrur,1002077,431664,570413,1655169,73636,570103
PUNJAB,Barnala,359831,157832,201999,595527,23657,212388
CHANDIGARH,Chandigarh,805438,340092,465346,1055450,174528,184265
UTTARAKHAND,Uttarkashi,215126,86889,128237,330086,18882,83896
UTTARAKHAND,Chamoli,280556,125161,155395,391605,27168,61950
UTTARAKHAND,Rudraprayag,170933,79130,91803,242285,15096,45428
UTTARAKHAND,Tehri Garhwal,407994,180588,227406,618931,30704,133013
UTTARAKHAND,Dehradun,1259506,557290,702216,1696694,247622,296538
UTTARAKHAND,Garhwal,494889,232741,262148,687271,52076,123071
UTTARAKHAND,Pithoragarh,345550,155927,189623,483439,28375,88036
UTTARAKHAND,Bageshwar,179483,81937,97546,259898,10900,49539
UTTARAKHAND,Almora,436497,204893,231604,622506,37742,109556
UTTARAKHAND,Champawat,177726,75711,102015,259648,15110,62429
UTTARAKHAND,Nainital,696500,310721,385779,954605,89101,166573
UTTARAKHAND,Udham Singh Nagar,1037839,439314,598525,1648902,111062,438598
UTTARAKHAND,Hardwar,1178354,486943,691411,1890422,134182,580970
HARYANA,Panchkula,405318,175456,229862,561293,83256,119222
HARYANA,Ambala,818025,356737,461288,1128350,91472,222031
HARYANA,Yamunanagar,832457,357664,474793,1214205,82532,319428
HARYANA,Kurukshetra,646893,276065,370828,964655,71007,266638
HARYANA,Kaithal,646529,260747,385782,1074304,51043,369869
HARYANA,Karnal,978013,413497,564516,1505324,101387,429220
HARYANA,Panipat,786599,322463,464136,1205437,75774,296212
HARYANA,Sonipat,998316,408435,589881,1450001,101186,344813
HARYANA,Jind,832758,330709,502049,1334152,64599,419624
HARYANA,Fatehabad,557578,230107,327471,942011,37741,344534
HARYANA,Sirsa,782897,325929,456968,1295189,61620,412353
HARYANA,Hisar,1114311,444111,670200,1743931,105346,505251
HARYANA,Bhiwani,1069871,426713,643158,1634445,104875,459364
HARYANA,Rohtak,747582,311557,436025,1061204,100346,248795
HARYANA,Jhajjar,676091,276611,399480,958405,58826,201028
HARYANA,Mahendragarh,630255,249815,380440,922088,60296,245602
HARYANA,Rewari,636947,261494,375453,900332,65143,206827
HARYANA,Gurgaon,1111116,472450,638666,1514432,233402,263720
HARYANA,Mewat,454897,146462,308435,1089263,12453,619284
HARYANA,Faridabad,1272739,537799,734940,1809733,259933,346567
HARYANA,Palwal,599796,220100,379696,1042708,43780,393825
NCT OF DELHI,North West,2707855,1165903,1541952,3656539,465677,416720
NCT OF DELHI,North,681517,299902,381615,887978,107099,125277
NCT OF DELHI,North East,1611588,699107,912481,2241624,122983,257966
NCT OF DELHI,East,1352998,604616,748382,1709346,246988,169693
NCT OF DELHI,New Delhi,114179,48501,65678,142004,23934,10098
NCT OF DELHI,Central,442360,201842,240518,582320,80251,87286
NCT OF DELHI,West,1961179,867246,1093933,2543243,440295,308139
NCT OF DELHI,South West,1787689,762428,1025261,2292958,400800,278832
NCT OF DELHI,South,2078402,893366,1185036,2731929,458858,328287
RAJASTHAN,Ganganagar,1193343,482435,710908,1969168,104071,710223
RAJASTHAN,Hanumangarh,1034136,409855,624281,1774692,84185,723454
RAJASTHAN,Bikaner,1278801,496402,782399,2363937,101714,1015331
RAJASTHAN,Churu,1149269,452540,696729,2039547,77282,910226
RAJASTHAN,Jhunjhunun,1370360,554526,815834,2137045,158936,712584
RAJASTHAN,Alwar,2182476,822647,1359829,3674179,222622,1384905
RAJASTHAN,Bharatpur,1480869,536959,943910,2548462,132571,1104824
RAJASTHAN,Dhaulpur,683098,247377,435721,1206516,37856,552106
RAJASTHAN,Karauli,805849,273945,531904,1458248,67639,668926
RAJASTHAN,Sawai Madhopur,741748,255564,486184,1335551,70870,586492
RAJASTHAN,Dausa,938051,341116,596935,1634409,90833,681980
RAJASTHAN,Jaipur,4300965,1746172,2554793,6626178,703673,2046038
RAJASTHAN,Sikar,1652117,656842,995275,2677333,181282,967497
RAJASTHAN,Nagaur,1758624,655874,1102750,3307743,117444,1533137
RAJASTHAN,Jodhpur,2031532,765779,1265753,3687165,177199,1591957
RAJASTHAN,Jaisalmer,308653,98238,210415,669919,10604,397649
RAJASTHAN,Barmer,1188322,404861,783461,2603751,39533,1501858
RAJASTHAN,Jalor,829582,285659,543923,1828730,25210,1033534
RAJASTHAN,Sirohi,476806,166906,309900,1036346,27076,577092
RAJASTHAN,Pali,1085693,418312,667381,2037573,67021,983050
RAJASTHAN,Ajmer,1526673,600405,926268,2583052,172683,1034334
RAJASTHAN,Tonk,749659,271330,478329,1421326,67155,661902
RAJASTHAN,Bundi,585044,213339,371705,1110906,41052,553622
RAJASTHAN,Bhilwara,1256126,478544,777582,2408523,106667,1180456
RAJASTHAN,Rajsamand,619139,235805,383334,1156597,34286,544517
RAJASTHAN,Dungarpur,681591,265771,415820,1388552,39312,764563
RAJASTHAN,Banswara,829343,315489,513854,1797485,47094,1040914
RAJASTHAN,Chittaurgarh,821825,306974,514851,1544338,67155,715545
RAJASTHAN,Kota,1298345,532949,765396,1951014,167778,588142
RAJASTHAN,Baran,693307,260700,432607,1222755,49939,545842
RAJASTHAN,Jhalawar,739792,272977,466815,1411129,47985,696680
RAJASTHAN,Udaipur,1582629,609185,973444,3068420,142672,1528671
RAJASTHAN,Pratapgarh,401515,151393,250122,867848,19109,488621
UTTAR PRADESH,Saharanpur,2077108,856994,1220114,3466382,154153,1279517
UTTAR PRADESH,Muzaffarnagar,2417339,968811,1448528,4143512,98691,1431537
UTTAR PRADESH,Bijnor,2135393,893922,1241471,3682713,148185,1308683
UTTAR PRADESH,Moradabad,2263848,906413,1357435,4772006,186489,2097292
UTTAR PRADESH,Rampur,1043666,413258,630408,2335819,43839,1235413
UTTAR PRADESH,Jyotiba Phule Nagar,983110,382569,600541,1840221,69522,520215
UTTAR PRADESH,Meerut,2141488,886968,1254520,3443689,275076,990312
UTTAR PRADESH,Baghpat,797970,308112,489858,1303048,44164,376700
UTTAR PRADESH,Ghaziabad,3123264,1311867,1811397,4681645,255949,885070
UTTAR PRADESH,Gautam Buddha Nagar,1122947,456882,666065,1648115,101645,342284
UTTAR PRADESH,Bulandshahr,2031656,778342,1253314,3499171,151182,1185318
UTTAR PRADESH,Aligarh,2092567,809187,1283380,3673889,172585,1352181
UTTAR PRADESH,Mahamaya Nagar,942572,363415,579157,1564708,49812,430814
UTTAR PRADESH,Mathura,1507746,564400,943346,2547184,103102,691359
UTTAR PRADESH,Agra,2680510,1065916,1614594,4418797,199395,963202
UTTAR PRADESH,Firozabad,1521806,609492,912314,2498156,108627,672115
UTTAR PRADESH,Mainpuri,1203885,491775,712110,1868529,111696,519493
UTTAR PRADESH,Budaun,1547477,560976,986501,3681896,64222,1946345
UTTAR PRADESH,Bareilly,2191759,849062,1342697,4448359,146446,1744527
UTTAR PRADESH,Pilibhit,1061095,406805,654290,2031007,66129,977839
UTTAR PRADESH,Shahjahanpur,1490930,575788,915142,3006538,87355,1324615
UTTAR PRADESH,Kheri,2034044,796887,1237157,4021243,128548,1833578
UTTAR PRADESH,Sitapur,2283733,886031,1397702,4483992,127750,2141696
UTTAR PRADESH,Hardoi,2221601,847014,1374587,4092845,103523,1481604
UTTAR PRADESH,Unnao,1773584,720521,1053063,3108367,101934,1130103
UTTAR PRADESH,Lucknow,3127260,1384820,1742440,4589838,639260,1146880
UTTAR PRADESH,Rae Bareli,1965843,799878,1165965,3405559,153041,1286726
UTTAR PRADESH,Farrukhabad,1092677,437850,654827,1885204,110391,710960
UTTAR PRADESH,Kannauj,1017087,413491,603596,1656616,95072,543034
UTTAR PRADESH,Etawah,1062003,438420,623583,1581810,118571,397708
UTTAR PRADESH,Auraiya,930836,384638,546198,1379545,79012,276224
UTTAR PRADESH,Kanpur Dehat,1170243,477279,692964,1796184,97740,475166
UTTAR PRADESH,Kanpur Nagar,3243022,1413843,1829179,4581268,396565,676306
UTTAR PRADESH,Jalaun,1075196,421766,653430,1689974,106888,461666
UTTAR PRADESH,Jhansi,1304513,520808,783705,1998603,92586,483088
UTTAR PRADESH,Lalitpur,641191,243605,397586,1221592,34658,509536
UTTAR PRADESH,Hamirpur,653299,245174,408125,1104285,59612,364848
UTTAR PRADESH,Mahoba,488106,185823,302283,875958,37165,403649
UTTAR PRADESH,Banda,1002937,372311,630626,1799410,63112,588025
UTTAR PRADESH,Chitrakoot,531072,200733,330339,991730,35826,383908
UTTAR PRADESH,Fatehpur,1512166,601163,911003,2632733,116445,895178
UTTAR PRADESH,Pratapgarh,1931559,810178,1121381,3209141,197846,1059636
UTTAR PRADESH,Kaushambi,813424,306145,507279,1599596,45341,670750
UTTAR PRADESH,Allahabad,3665727,1466387,2199340,5954391,428871,1756098
UTTAR PRADESH,Bara Banki,1692458,681940,1010518,3260699,113799,1540841
UTTAR PRADESH,Faizabad,1450901,612562,838339,2470996,179996,981915
UTTAR PRADESH,Ambedkar Nagar,1486939,640263,846676,2397888,194387,813502
UTTAR PRADESH,Sultanpur,2239902,939654,1300248,3797117,176414,1118891
UTTAR PRADESH,Bahraich,1398368,520083,878285,3487731,47690,1920966
UTTAR PRADESH,Shrawasti,423313,146613,276700,1117361,15648,701550
UTTAR PRADESH,Balrampur,868357,323414,544943,2148665,37109,1332817
UTTAR PRADESH,Gonda,1679994,645813,1034181,3433919,118176,1620782
UTTAR PRADESH,Siddharthnagar,1228926,488208,740718,2559297,56516,1217027
UTTAR PRADESH,Basti,1393783,574064,819719,2464464,143642,1021192
UTTAR PRADESH,Sant Kabir Nagar,954949,387851,567098,1715183,63506,683053
UTTAR PRADESH,Mahrajganj,1419144,537470,881674,2684703,95863,1252595
UTTAR PRADESH,Gorakhpur,2700328,1106438,1593890,4440895,273903,1453960
UTTAR PRADESH,Kushinagar,1954820,771098,1183722,3564544,119625,1550315
UTTAR PRADESH,Deoria,1875239,795951,1079288,3100946,194341,1130108
UTTAR PRADESH,Azamgarh,2771917,1212503,1559414,4613913,158303,1218146
UTTAR PRADESH,Mau,1363044,589962,773082,2205968,150462,659237
UTTAR PRADESH,Ballia,1963590,802630,1160960,3239774,200434,1032533
UTTAR PRADESH,Jaunpur,2731677,1166283,1565394,4494204,256398,1344789
UTTAR PRADESH,Ghazipur,2197549,903996,1293553,3620268,186306,1008996
UTTAR PRADESH,Chandauli,1174606,475152,699454,1952756,88299,543247
UTTAR PRADESH,Varanasi,2403903,1014787,1389116,3676841,281652,906367
UTTAR PRADESH,Sant Ravidas Nagar (Bhadohi),910146,363364,546782,1578213,86533,552958
UTTAR PRADESH,Mirzapur,1428683,562846,865837,2496970,140668,868542
UTTAR PRADESH,Sonbhadra,985708,383720,601988,1862559,63846,745126
UTTAR PRADESH,Etah,1055202,408160,647042,1774480,88607,718310
UTTAR PRADESH,Kanshiram Nagar,724850,272047,452803,1436719,48079,648166
BIHAR,Pashchim Champaran,1759481,668255,1091226,3935042,70669,1710878
BIHAR,Purba Champaran,2276957,869354,1407603,5099371,68781,2142757
BIHAR,Sheohar,283698,112053,171645,656246,10091,348078
BIHAR,Sitamarhi,1436794,551606,885188,3423574,70549,1852765
BIHAR,Madhubani,2155338,815253,1340085,4487379,137780,2003079
BIHAR,Supaul,1033283,385611,647672,2229076,45726,1220268
BIHAR,Araria,1195768,468125,727643,2811569,39627,1653766
BIHAR,Kishanganj,745056,305135,439921,1690400,15386,945397
BIHAR,Purnia,1332326,527065,805261,3264619,59996,1798786
BIHAR,Katihar,1280190,517934,762256,3071029,57114,1705551
BIHAR,Madhepura,834577,316911,517666,2001762,44955,1202278
BIHAR,Saharsa,804996,298622,506374,1900661,47051,1151349
BIHAR,Darbhanga,1816634,691068,1125566,3937385,129597,2203198
BIHAR,Muzaffarpur,2509232,1022115,1487117,4801062,138916,1924438
BIHAR,Gopalganj,1382998,589093,793905,2562012,79109,977719
BIHAR,Siwan,1930175,814269,1115906,3330464,119164,1207119
BIHAR,Saran,2157454,871687,1285767,3951862,148065,1313700
BIHAR,Vaishali,1926740,774164,1152576,3495021,124448,1479152
BIHAR,Samastipur,2142880,849305,1293575,4261566,129933,1996651
BIHAR,Begusarai,1548673,630166,918507,2970541,101836,1242551
BIHAR,Khagaria,768028,306875,461153,1666886,38697,903323
BIHAR,Bhagalpur,1573066,635397,937669,3037766,118843,1139715
BIHAR,Banka,965321,374360,590961,2034763,35767,879831
BIHAR,Munger,801817,328076,473741,1367765,64469,498676
BIHAR,Lakhisarai,507270,202088,305182,1000912,27261,450967
BIHAR,Sheikhpura,328676,132245,196431,636342,19676,305609
BIHAR,Nalanda,1519933,600375,919558,2877653,133032,1324385
BIHAR,Patna,3459679,1431632,2028047,5838465,452340,2590473
BIHAR,Bhojpur,1599151,625665,973486,2728407,131137,1005140
BIHAR,Buxar,989807,396263,593544,1706352,64117,457814
BIHAR,Kaimur (Bhabua),920276,370353,549923,1626384,70169,551317
BIHAR,Rohtas,1799832,738049,1061783,2959918,161555,876443
BIHAR,Aurangabad,1466002,597269,868733,2540073,91371,784131
BIHAR,Gaya,2297613,928810,1368803,4391418,131163,1953368
BIHAR,Nawada,1091012,431538,659474,2219146,64585,1091439
BIHAR,Jamui,858588,324203,534385,1760405,29633,765297
BIHAR,Jehanabad,618881,244469,374412,1125313,45519,495877
BIHAR,Arwal,386351,151072,235279,700843,27945,290095
SIKKIM,North  District,30450,11871,18579,43709,1406,7673
SIKKIM,West District,93432,41444,51988,136435,4831,28227
SIKKIM,South District,106741,47384,59357,146850,5766,24395
SIKKIM,East District,214329,92984,121345,283583,20904,38142
ARUNACHAL PRADESH,Tawang,26073,8353,17720,49977,1379,19203
ARUNACHAL PRADESH,West Kameng,48492,18926,29566,83947,2693,25606
ARUNACHAL PRADESH,East Kameng,38449,16850,21599,78690,2330,31763
ARUNACHAL PRADESH,Papum Pare,121048,55254,65794,176573,13840,30360
ARUNACHAL PRADESH,Upper Subansiri,45278,20471,24807,83448,4276,28364
ARUNACHAL PRADESH,West Siang,64746,27969,36777,112274,6030,27956
ARUNACHAL PRADESH,East Siang,62576,28366,34210,99214,6540,21543
ARUNACHAL PRADESH,Upper Siang,18195,7472,10723,35320,1349,11209
ARUNACHAL PRADESH,Changlang,73174,29147,44027,148226,3633,57290
ARUNACHAL PRADESH,Tirap,47974,18661,29313,111975,2134,50628
ARUNACHAL PRADESH,Lower Subansiri,54057,24587,29470,83030,5230,17273
ARUNACHAL PRADESH,Kurung Kumey,36606,16348,20258,92076,2031,42621
ARUNACHAL PRADESH,Dibang Valley,4436,1822,2614,8004,356,2185
ARUNACHAL PRADESH,Lower Dibang Valley,31849,13762,18087,54080,2795,14406
ARUNACHAL PRADESH,Lohit,83062,34682,48380,145726,5180,52421
ARUNACHAL PRADESH,Anjaw,9990,3467,6523,21167,502,8723
NAGALAND,Mon,119626,52194,67432,250260,1772,130529
NAGALAND,Mokokchung,159494,76015,83479,194622,10299,22555
NAGALAND,Zunheboto,102881,49377,53504,140757,5560,25988
NAGALAND,Wokha,128208,60823,67385,166343,8030,25048
NAGALAND,Dimapur,278037,127895,150142,378811,27532,58926
NAGALAND,Phek,105893,47967,57926,163418,5926,44456
NAGALAND,Tuensang,117511,53858,63653,196596,2760,66450
NAGALAND,Longleng,29859,13720,16139,50484,595,18230
NAGALAND,Kiphire,41232,18557,22675,74004,997,32120
NAGALAND,Kohima,197489,90451,107038,267988,23439,45802
NAGALAND,Peren,62204,27620,34584,95219,2169,24790
MANIPUR,Senapati,264477,116465,148012,479148,24940,191001
MANIPUR,Tamenglong,85006,37603,47403,140651,7102,45317
MANIPUR,Churachandpur,195935,91922,104013,274143,14523,57561
MANIPUR,Bishnupur,156333,69020,87313,237399,20074,67610
MANIPUR,Thoubal,269304,116687,152617,422168,28550,118088
MANIPUR,Imphal West,392626,186641,205985,517992,81876,87248
MANIPUR,Imphal East,324664,151350,173314,456113,50647,90250
MANIPUR,Ukhrul,129829,59681,70148,183998,15636,42156
MANIPUR,Chandel,90302,39249,51053,144182,8105,38191
MIZORAM,Mamit,60191,27214,32977,86364,1771,20091
MIZORAM,Kolasib,65895,31748,34147,83955,2530,14217
MIZORAM,Aizawl,340595,171048,169547,400309,31310,38248
MIZORAM,Champhai,100802,49362,51440,125745,4087,15449
MIZORAM,Serchhip,54476,26878,27598,64937,2128,5963
MIZORAM,Lunglei,121122,56607,64515,161428,5509,32451
MIZORAM,Lawngtlai,62861,26417,36444,117894,2515,54874
MIZORAM,Saiha,42233,20372,21861,56574,2204,8787
TRIPURA,West Tripura,1361354,638356,722998,1725739,85405,279053
TRIPURA,South Tripura,646810,295728,351082,876001,26870,188363
TRIPURA,Dhalai,276217,124574,151643,378230,6425,109130
TRIPURA,North Tripura,520402,244756,275646,693947,18419,156840
MEGHALAYA,West Garo Hills,358702,165264,193438,643291,10856,208900
MEGHALAYA,East Garo Hills,192147,89634,102513,317917,2484,100781
MEGHALAYA,South Garo Hills,82062,37059,45003,142334,826,44849
MEGHALAYA,West Khasi Hills,230678,113371,117307,383461,6450,133244
MEGHALAYA,Ribhoi,155859,74882,80977,258840,3911,78974
MEGHALAYA,East Khasi Hills,578030,290760,287270,825922,61639,168575
MEGHALAYA,Jaintia Hills,187527,100156,87371,395124,8039,165184
ASSAM,Kokrajhar,489305,214085,275220,887142,17287,340601
ASSAM,Dhubri,922341,410790,511551,1949258,34401,992068
ASSAM,Goalpara,563577,259275,304302,1008183,18294,375071
ASSAM,Barpeta,897058,398020,499038,1693622,46947,664161
ASSAM,Morigaon,539902,250204,289698,957423,18462,351756
ASSAM,Nagaon,1710716,788866,921850,2823768,66994,873197
ASSAM,Sonitpur,1108572,488047,620525,1924110,49901,627141
ASSAM,Lakhimpur,683486,307934,375552,1042137,44212,275677
ASSAM,Dhemaji,423028,185267,237761,686133,28006,194984
ASSAM,Tinsukia,798322,344873,453449,1327929,38152,417081
ASSAM,Dibrugarh,884531,393170,491361,1326335,59380,340744
ASSAM,Sivasagar,813505,368738,444767,1151050,53437,247114
ASSAM,Jorhat,794929,362594,432335,1092256,62608,209170
ASSAM,Golaghat,721764,325289,396475,1066888,36887,258897
ASSAM,Karbi Anglong,557214,242961,314253,956313,18225,310093
ASSAM,Dima Hasao,140873,62314,78559,214102,5565,57631
ASSAM,Cachar,1174128,534182,639946,1736617,45341,357907
ASSAM,Karimganj,795297,359355,435942,1228686,21408,303785
ASSAM,Hailakandi,407366,180530,226836,659296,11608,173306
ASSAM,Bongaigaon,434078,196964,237114,738804,20221,260721
ASSAM,Chirang,259902,114033,145869,482162,6594,172939
ASSAM,Kamrup,995319,445100,550219,1517542,55011,392678
ASSAM,Kamrup Metropolitan,1001191,463964,537227,1253938,167972,128773
ASSAM,Nalbari,531771,238587,293184,771639,39368,188960
ASSAM,Baksa,572837,250223,322614,950075,15422,294784
ASSAM,Darrang,487039,218373,268666,928500,22267,375556
ASSAM,Udalguri,469926,205600,264326,831668,14001,306833
WEST BENGAL,Darjiling,1315585,597912,717673,1846823,110193,415353
WEST BENGAL,Jalpaiguri,2498780,1102158,1396622,3872846,129393,1203423
WEST BENGAL,Koch Bihar,1850504,821771,1028733,2819086,81100,873135
WEST BENGAL,Uttar Dinajpur,1489667,636172,853495,3007134,59457,1431264
WEST BENGAL,Dakshin Dinajpur,1083685,487211,596474,1676276,52345,534394
WEST BENGAL,Maldah,2086432,934413,1152019,3988845,92207,1960034
WEST BENGAL,Murshidabad,4055834,1878647,2177187,7103807,170051,3031841
WEST BENGAL,Birbhum,2158447,956966,1201481,3502404,115743,1346802
WEST BENGAL,Barddhaman,5247208,2329168,2918040,7717563,439823,2196886
WEST BENGAL,Nadia,3480555,1601689,1878866,5167600,209562,1570127
WEST BENGAL,North Twenty Four Parganas,7608693,3552647,4056046,10009781,852923,1901634
WEST BENGAL,Hugli,4078388,1866611,2211777,5519145,380060,1180806
WEST BENGAL,Bankura,2232992,933655,1299337,3596674,133465,1417787
WEST BENGAL,Puruliya,1624905,622847,1002058,2930115,77621,1272799
WEST BENGAL,Haora,3605206,1662382,1942824,4850029,304594,926661
WEST BENGAL,Kolkata,3588137,1661222,1926915,4496694,691804,410988
WEST BENGAL,South Twenty Four Parganas,5531657,2488380,3043277,8161961,322157,2184508
WEST BENGAL,Paschim Medinipur,4078412,1811499,2266913,5913457,211437,1689984
WEST BENGAL,Purba Medinipur,3923194,1774121,2149073,5095875,184225,1021541
JHARKHAND,Garhwa,653476,248315,405161,1322784,28144,557852
JHARKHAND,Chatra,510061,206159,303902,1042886,21697,467975
JHARKHAND,Kodarma,390249,151469,238780,716259,20907,297992
JHARKHAND,Giridih,1253475,469739,783736,2445474,55122,1047685
JHARKHAND,Deoghar,793538,303701,489837,1492073,43979,635544
JHARKHAND,Godda,604519,228307,376212,1313551,30870,653464
JHARKHAND,Sahibganj,483263,195960,287303,1150567,19832,637296
JHARKHAND,Pakur,352881,145892,206989,900422,9822,548434
JHARKHAND,Dhanbad,1722204,707254,1014950,2684487,107382,662522
JHARKHAND,Bokaro,1273520,514432,759088,2062330,116396,595924
JHARKHAND,Lohardaga,259707,110139,149568,461790,13847,188323
JHARKHAND,Purbi Singhbhum,1507699,651173,856526,2293919,157688,525916
JHARKHAND,Palamu,1024563,402857,621706,1939869,63595,803424
JHARKHAND,Latehar,350682,140976,209706,726978,13956,349277
JHARKHAND,Hazaribagh,1013249,417136,596113,1734495,79898,613774
JHARKHAND,Ramgarh,596497,246466,350031,949443,47207,292062
JHARKHAND,Dumka,672409,266134,406275,1321442,25593,601078
JHARKHAND,Jamtara,426312,168052,258260,791042,14802,366012
JHARKHAND,Ranchi,1911433,826189,1085244,2914253,195181,613855
JHARKHAND,Khunti,284575,119834,164741,531885,10130,177856
JHARKHAND,Gumla,559720,237925,321795,1025213,23742,322119
JHARKHAND,Simdega,343483,151492,191991,599578,13674,191341
JHARKHAND,Pashchimi Singhbhum,727561,288288,439273,1502338,10743,279016
JHARKHAND,Saraikela-Kharsawan,612993,247661,365332,1065056,29840,228943
ORISSA,Bargarh,983783,426566,557217,1481255,49238,442733
ORISSA,Jharsuguda,405879,177787,228092,579505,22010,143508
ORISSA,Sambalpur,703691,310499,393192,1041099,45828,282248
ORISSA,Debagarh,197819,85170,112649,312520,9041,108811
ORISSA,Sundargarh,1342322,592175,750147,2093437,94710,660465
ORISSA,Kendujhar,1052518,447399,605119,1801733,57762,700661
ORISSA,Mayurbhanj,1369397,575226,794171,2519738,72847,1094844
ORISSA,Baleshwar,1621232,718873,902359,2320529,105962,628627
ORISSA,Bhadrak,1094140,497871,596269,1506337,67536,323145
ORISSA,Kendrapara,1089265,509295,579970,1440361,75926,294723
ORISSA,Jagatsinghapur,889027,407978,481049,1136971,70602,209984
ORISSA,Cuttack,2011469,908436,1103033,2624470,181601,472182
ORISSA,Jajapur,1290455,584059,706396,1827192,87623,460953
ORISSA,Dhenkanal,829910,365817,464093,1192811,43064,341887
ORISSA,Anugul,869456,375031,494425,1273821,45588,347851
ORISSA,Nayagarh,688362,296029,392333,962789,33148,232558
ORISSA,Khordha,1749936,792421,957515,2251673,247498,371244
ORISSA,Puri,1291939,587082,704857,1698730,87000,309790
ORISSA,Ganjam,2210050,947398,1262652,3529031,97147,1055331
ORISSA,Gajapati,262537,108874,153663,577817,12556,335821
ORISSA,Kandhamal,399786,165886,233900,733110,14962,287948
ORISSA,Baudh,271612,112964,158648,441162,8124,146392
ORISSA,Subarnapur,398421,168028,230393,610183,16745,167244
ORISSA,Balangir,927260,381588,545672,1648997,42401,721389
ORISSA,Nuapada,299383,118480,180903,610382,10131,316086
ORISSA,Kalahandi,802036,317859,484177,1576869,27385,765368
ORISSA,Rayagada,407735,165776,241959,967911,17681,583140
ORISSA,Nabarangapur,470379,183395,286984,1220946,11198,739190
ORISSA,Koraput,568090,227247,340843,1379647,29000,770707
ORISSA,Malkangiri,244706,97705,147001,613192,5585,390356
CHHATTISGARH,Koriya,397823,167900,229923,658917,26802,179639
CHHATTISGARH,Surguja,1187941,493255,694686,2359886,64607,991866
CHHATTISGARH,Jashpur,495415,214759,280656,851669,26161,328438
CHHATTISGARH,Raigarh,951639,408883,542756,1493984,66358,460166
CHHATTISGARH,Korba,748759,315368,433391,1206640,61215,410186
CHHATTISGARH,Janjgir - Champa,1019634,425955,593679,1619707,58712,587734
CHHATTISGARH,Bilaspur,1596560,664086,932474,2663629,134637,943112
CHHATTISGARH,Kabeerdham,414167,165664,248503,822526,16671,376852
CHHATTISGARH,Rajnandgaon,1008379,447024,561355,1537133,51698,467554
CHHATTISGARH,Durg,2303378,1018766,1284612,3343872,202424,823501
CHHATTISGARH,Raipur,2629749,1136591,1493158,4063872,227382,1247434
CHHATTISGARH,Mahasamund,637963,273874,364089,1032754,33357,384764
CHHATTISGARH,Dhamtari,546833,242909,303924,799781,31319,214637
CHHATTISGARH,Uttar Bastar Kanker,456042,197744,258298,748941,21410,243039
CHHATTISGARH,Bastar,650863,268528,382335,1413199,32895,729550
CHHATTISGARH,Narayanpur,56621,23172,33449,139820,2216,78331
CHHATTISGARH,Dakshin Bastar Dantewada,191237,74708,116529,533638,11197,336963
CHHATTISGARH,Bijapur,86919,32843,54076,255230,3421,163278
MADHYA PRADESH,Sheopur,328025,119824,208201,687861,17091,393141
MADHYA PRADESH,Morena,1179685,432033,747652,1965970,71005,706917
MADHYA PRADESH,Bhind,1094917,418404,676513,1703005,50222,388473
MADHYA PRADESH,Gwalior,1357210,554096,803114,2032036,193947,554486
MADHYA PRADESH,Datia,491445,187630,303815,786754,34853,260076
MADHYA PRADESH,Shivpuri,900846,327604,573242,1726050,44812,719547
MADHYA PRADESH,Tikamgarh,747940,288587,459353,1445166,35034,659348
MADHYA PRADESH,Chhatarpur,943033,371023,572010,1762375,59704,770268
MADHYA PRADESH,Panna,552559,220419,332140,1016520,29795,427997
MADHYA PRADESH,Sagar,1545719,637112,908607,2378458,116753,711804
MADHYA PRADESH,Damoh,747715,301978,445737,1264219,41158,469038
MADHYA PRADESH,Satna,1371781,570730,801051,2228935,105499,715509
MADHYA PRADESH,Rewa,1441757,596185,845572,2365106,122371,766166
MADHYA PRADESH,Umaria,356672,145765,210907,644758,18144,230782
MADHYA PRADESH,Neemuch,508834,200945,307889,826067,42343,289113
MADHYA PRADESH,Mandsaur,834591,331693,502898,1340411,52546,467002
MADHYA PRADESH,Ratlam,825880,340790,485090,1455069,67192,622153
MADHYA PRADESH,Ujjain,1240990,510173,730817,1986864,111290,659279
MADHYA PRADESH,Shajapur,894612,351103,543509,1512681,48671,544791
MADHYA PRADESH,Dewas,925369,374653,550716,1563715,55383,565365
MADHYA PRADESH,Dhar,1077338,438859,638479,2185793,66721,1021851
MADHYA PRADESH,Indore,2309130,1019499,1289631,3276697,382658,718174
MADHYA PRADESH,Khargone (West Nimar),986234,410806,575428,1873046,64150,932619
MADHYA PRADESH,Barwani,549926,236284,313642,1385881,30754,825034
MADHYA PRADESH,Rajgarh,804245,315448,488797,1545814,51499,706958
MADHYA PRADESH,Vidisha,862918,350574,512344,1458875,59814,512311
MADHYA PRADESH,Bhopal,1660690,740376,920314,2371061,266618,462581
MADHYA PRADESH,Sehore,780362,311154,469208,1311332,50655,508396
MADHYA PRADESH,Raisen,820220,341127,479093,1331597,48384,444877
MADHYA PRADESH,Betul,939769,409986,529783,1575362,82761,603098
MADHYA PRADESH,Harda,352550,148743,203807,570465,27126,177731
MADHYA PRADESH,Hoshangabad,810644,341445,469199,1241350,84769,344492
MADHYA PRADESH,Katni,790773,330190,460583,1292042,53578,465374
MADHYA PRADESH,Jabalpur,1756468,776161,980307,2463289,235072,540029
MADHYA PRADESH,Narsimhapur,718785,305294,413491,1091854,52763,356987
MADHYA PRADESH,Dindori,378714,155955,222759,704524,15179,295655
MADHYA PRADESH,Mandla,604962,256929,348033,1054905,35476,376944
MADHYA PRADESH,Chhindwara,1294198,562904,731294,2090922,112383,663446
MADHYA PRADESH,Seoni,864194,378853,485341,1379131,55984,458811
MADHYA PRADESH,Balaghat,1147623,521155,626468,1701698,74213,493415
MADHYA PRADESH,Guna,653980,253443,400537,1241519,42147,578034
MADHYA PRADESH,Ashoknagar,469109,178805,290304,845071,22791,359525
MADHYA PRADESH,Shahdol,604194,255433,348761,1066063,46513,422736
MADHYA PRADESH,Anuppur,436595,182475,254120,749237,31646,271733
MADHYA PRADESH,Sidhi,600785,247755,353030,1127033,33067,477472
MADHYA PRADESH,Singrauli,585054,225131,359923,1178273,30597,517447
MADHYA PRADESH,Jhabua,352081,137499,214582,1025048,20240,775664
MADHYA PRADESH,Alirajpur,209754,88849,120905,728999,10040,658684
MADHYA PRADESH,Khandwa (East Nimar),731615,299356,432259,1310061,42771,551824
MADHYA PRADESH,Burhanpur,408679,175606,233073,757847,28237,317962
GUJARAT,Kachchh,1252319,513080,739239,2092371,60386,581952
GUJARAT,Banas Kantha,1704923,656521,1048402,3120506,66950,1207376
GUJARAT,Patan,837913,343282,494631,1343734,46355,452891
GUJARAT,Mahesana,1502645,655146,847499,2035064,130723,434497
GUJARAT,Sabar Kantha,1578734,660109,918625,2428589,110817,665058
GUJARAT,Gandhinagar,1030494,447808,582686,1391753,108400,246993
GUJARAT,Ahmadabad,5435760,2410297,3025463,7214225,839295,1129562
GUJARAT,Surendranagar,1093626,450405,643221,1756268,58389,493427
GUJARAT,Rajkot,2725056,1210981,1514075,3804558,266295,738660
GUJARAT,Jamnagar,1396534,601394,795140,2160119,87523,502873
GUJARAT,Porbandar,393678,172057,221621,585449,22458,137119
GUJARAT,Junagadh,1842818,795837,1046981,2743082,139957,669022
GUJARAT,Amreli,995459,437279,558180,1514190,50999,380595
GUJARAT,Bhavnagar,1887255,799884,1087371,2880365,93391,508664
GUJARAT,Anand,1551253,676772,874481,2092745,110351,360506
GUJARAT,Kheda,1660243,717763,942480,2299885,84223,482078
GUJARAT,Panch Mahals,1440805,582751,858054,2390776,71810,781582
GUJARAT,Dohad,1007171,408136,599035,2127086,41458,1047088
GUJARAT,Vadodara,2893080,1278993,1614087,4165626,314960,910219
GUJARAT,Narmada,370336,158569,211767,590297,14748,192780
GUJARAT,Bharuch,1118276,495229,623047,1551019,74380,273829
GUJARAT,The Dangs,140968,63654,77314,228291,3490,91160
GUJARAT,Navsari,1001909,462438,539471,1329672,85041,261956
GUJARAT,Valsad,1170657,515129,655528,1705678,90912,405928
GUJARAT,Surat,4571410,1883942,2687468,6081322,379505,942150
GUJARAT,Tapi,490036,221029,269007,807022,31743,292102
DAMAN AND DIU,Diu,38058,17731,20327,52074,1906,10735
DAMAN AND DIU,Daman,150348,46032,104316,191173,9128,20641
DADRA AND NAGAR HAVELI,Dadra AND Nagar Haveli,223230,80709,142521,343709,19655,91055
MAHARASHTRA,Nandurbar,906509,394410,512099,1648295,58461,790613
MAHARASHTRA,Dhule,1293916,570528,723388,2050862,114931,649568
MAHARASHTRA,Jalgaon,2891882,1262659,1629223,4229917,229987,1003050
MAHARASHTRA,Buldana,1879874,830982,1048892,2586258,113783,600436
MAHARASHTRA,Akola,1411281,652304,758977,1813906,112574,352687
MAHARASHTRA,Washim,869917,382214,487703,1197160,47865,291525
MAHARASHTRA,Amravati,2251875,1044771,1207104,2888445,203273,478074
MAHARASHTRA,Wardha,1019458,466841,552617,1300774,93772,212054
MAHARASHTRA,Nagpur,3673808,1714588,1959220,4653570,493236,601547
MAHARASHTRA,Bhandara,899860,411151,488709,1200334,67061,235524
MAHARASHTRA,Gondiya,1004243,461406,542837,1322507,57923,256549
MAHARASHTRA,Gadchiroli,708365,313255,395110,1072942,35809,360229
MAHARASHTRA,Chandrapur,1578615,706050,872565,2204307,126488,516728
MAHARASHTRA,Yavatmal,2022574,906594,1115980,2772348,123074,718204
MAHARASHTRA,Nanded,2189425,934203,1255222,3361292,156225,884626
MAHARASHTRA,Hingoli,790743,340192,450551,1177345,38698,331388
MAHARASHTRA,Parbhani,1157814,491523,666291,1836086,81333,552643
MAHARASHTRA,Jalna,1195523,496095,699428,1959046,64060,545980
MAHARASHTRA,Aurangabad,2503837,1072901,1430936,3701282,253253,819734
MAHARASHTRA,Nashik,4345366,1947828,2397538,6107187,373100,1481778
MAHARASHTRA,Thane,8227161,3635765,4591396,11060148,961719,1692022
MAHARASHTRA,Mumbai Suburban,7575485,3352456,4223029,9356962,1183117,1111093
MAHARASHTRA,Mumbai,2509022,1098342,1410680,3085411,343374,262312
MAHARASHTRA,Raigarh,1939994,880302,1059692,2634200,204507,482420
MAHARASHTRA,Pune,7171723,3231513,3940210,9429408,1086650,1353077
MAHARASHTRA,Ahmadnagar,3151890,1378535,1773355,4543159,315842,1061271
MAHARASHTRA,Bid,1718507,731322,987185,2585049,129996,821607
MAHARASHTRA,Latur,1650672,718240,932432,2454196,153256,596213
MAHARASHTRA,Osmanabad,1137810,493506,644304,1657576,96847,440363
MAHARASHTRA,Solapur,2910676,1259410,1651266,4317756,236302,976795
MAHARASHTRA,Satara,2225694,1024660,1201034,3003741,243457,545423
MAHARASHTRA,Ratnagiri,1199392,580380,619012,1615069,65700,319622
MAHARASHTRA,Sindhudurg,666067,317778,348289,849651,48418,121922
MAHARASHTRA,Kolhapur,2825845,1266085,1559760,3876001,335413,778000
MAHARASHTRA,Sangli,2049467,927917,1121550,2822143,214003,579039
ANDHRA PRADESH,Adilabad,1483347,626997,856350,2741239,100226,1030640
ANDHRA PRADESH,Nizamabad,1389810,599596,790214,2551335,141850,1041862
ANDHRA PRADESH,Karimnagar,2206829,949591,1257238,3776269,256633,1280393
ANDHRA PRADESH,Medak,1637137,683731,953406,3033288,127493,1199818
ANDHRA PRADESH,Hyderabad,2892155,1349467,1542688,3943323,558090,556902
ANDHRA PRADESH,Rangareddy,3538028,1589244,1948784,5296741,740896,1158473
ANDHRA PRADESH,Mahbubnagar,1940646,782260,1158386,4053028,98227,1604319
ANDHRA PRADESH,Nalgonda,2001019,840262,1160757,3488809,196134,1294811
ANDHRA PRADESH,Warangal,2065023,885233,1179790,3512576,248942,1191252
ANDHRA PRADESH,Khammam,1630234,728594,901640,2797370,160804,875272
ANDHRA PRADESH,Srikakulam,1495381,637557,857824,2703114,121213,1009992
ANDHRA PRADESH,Vizianagaram,1238388,530885,707503,2344474,103591,1031683
ANDHRA PRADESH,Visakhapatnam,2568249,1145371,1422878,4290589,289734,1418851
ANDHRA PRADESH,East Godavari,3288577,1571644,1716933,5154296,263023,1524603
ANDHRA PRADESH,West Godavari,2652389,1273166,1379223,3936966,207586,1028767
ANDHRA PRADESH,Krishna,3009718,1410759,1598959,4517398,328454,1352499
ANDHRA PRADESH,Guntur,2960441,1325715,1634726,4887813,221924,1474349
ANDHRA PRADESH,Prakasam,1904435,796749,1107686,3397448,133627,1218310
ANDHRA PRADESH,Sri Potti Sriramulu Nellore,1832189,820267,1011922,2963557,148394,940785
ANDHRA PRADESH,Y.S.R.,1716766,722067,994699,2882469,116330,893657
ANDHRA PRADESH,Kurnool,2127161,880792,1246369,4053463,115504,1517933
ANDHRA PRADESH,Anantapur,2310960,972486,1338474,4081148,144915,1369069
ANDHRA PRADESH,Chittoor,2667878,1183084,1484794,4174064,246409,1170993
KARNATAKA,Belgaum,3052032,1326484,1725548,4779661,201884,1346776
KARNATAKA,Bagalkot,1113412,472024,641388,1889752,82319,608843
KARNATAKA,Bijapur,1248268,517702,730566,2177331,96990,746979
KARNATAKA,Bidar,1042673,445475,597198,1703300,54900,515395
KARNATAKA,Raichur,979769,402556,577213,1928812,50463,783126
KARNATAKA,Koppal,809085,340300,468785,1389920,43967,472182
KARNATAKA,Gadag,700177,302999,397178,1064570,42053,306138
KARNATAKA,Dharwad,1301664,589888,711776,1847023,137768,428556
KARNATAKA,Uttara Kannada,1081906,499807,582099,1437169,94767,277857
KARNATAKA,Haveri,1085443,481650,603793,1597668,55310,383494
KARNATAKA,Bellary,1421621,608181,813440,2452595,89475,787762
KARNATAKA,Chitradurga,1087392,480204,607188,1659456,75262,452975
KARNATAKA,Davanagere,1308540,587903,720637,1945497,123863,467414
KARNATAKA,Shimoga,1263016,588078,674938,1752753,111753,355222
KARNATAKA,Udupi,926429,460725,465704,1177361,107279,204028
KARNATAKA,Chikmagalur,818345,380088,438257,1137961,72420,204371
KARNATAKA,Tumkur,1813391,807367,1006024,2678980,143735,686274
KARNATAKA,Bangalore,7512276,3434235,4078041,9621551,1733274,1304048
KARNATAKA,Mandya,1149649,510981,638668,1805769,102838,504734
KARNATAKA,Hassan,1225256,556420,668836,1776421,103152,401227
KARNATAKA,Dakshina Kannada,1666323,802304,864019,2089649,185916,298846
KARNATAKA,Kodagu,412877,197575,215302,554519,43225,91352
KARNATAKA,Mysore,1962180,898414,1063766,3001127,212541,747237
KARNATAKA,Chamarajanagar,565279,252322,312957,1020791,34799,401643
KARNATAKA,Gulbarga,1427368,599009,828359,2566326,104256,883704
KARNATAKA,Yadgir,510003,203252,306751,1174271,27728,579042
KARNATAKA,Kolar,1016219,452109,564110,1536401,71422,399089
KARNATAKA,Chikkaballapura,783222,341064,442158,1255104,55056,380402
KARNATAKA,Bangalore Rural,688749,303438,385311,990923,51015,205062
KARNATAKA,Ramanagara,674758,296297,378461,1082636,46318,324721
GOA,North Goa,663060,311322,351738,818008,86781,99538
GOA,South Goa,502427,238342,264085,640537,57460,88577
LAKSHADWEEP,Lakshadweep,52553,24530,28023,64473,3491,5953
KERALA,Kasaragod,1037492,521016,516476,1307375,76192,212905
KERALA,Kannur,2138434,1125478,1012956,2523003,217203,279352
KERALA,Wayanad,645585,317449,328136,817420,51111,131211
KERALA,Kozhikode,2615443,1348504,1266939,3086293,250117,335520
KERALA,Malappuram,3311315,1713911,1597404,4112920,203779,622345
KERALA,Palakkad,2239492,1116892,1122600,2809934,180540,439934
KERALA,Thrissur,2678548,1396287,1282261,3121200,338600,307665
KERALA,Ernakulam,2855676,1429953,1425723,3282388,429880,268315
KERALA,Idukki,923010,451129,471881,1108974,86136,126589
KERALA,Kottayam,1749798,888206,861592,1974551,221350,134393
KERALA,Alappuzha,1852797,962245,890552,2127789,198858,163991
KERALA,Pathanamthitta,1062553,563372,499181,1197412,123549,71053
KERALA,Kollam,2240273,1165928,1074345,2635375,233402,231286
KERALA,Thiruvananthapuram,2785408,1430551,1354857,3301427,381782,309042
TAMIL NADU,Thiruvallur,2791721,1296010,1495711,3728104,451321,610048
TAMIL NADU,Chennai,3776276,1808197,1968079,4646732,905515,419065
TAMIL NADU,Kancheepuram,3013382,1401921,1611461,3998252,526886,678374
TAMIL NADU,Vellore,2773928,1269573,1504355,3936331,308514,891430
TAMIL NADU,Tiruvannamalai,1626813,717010,909803,2464875,158041,672427
TAMIL NADU,Viluppuram,2195776,961297,1234479,3458873,229726,999902
TAMIL NADU,Salem,2285562,1000455,1285107,3482056,296399,955045
TAMIL NADU,Namakkal,1176131,522819,653312,1726601,169206,388418
TAMIL NADU,Erode,1492662,664362,828300,2251744,215514,608003
TAMIL NADU,The Nilgiris,569647,270200,299447,735394,69657,114497
TAMIL NADU,Dindigul,1481834,665654,816180,2159775,163050,480681
TAMIL NADU,Karur,727044,325318,401726,1064493,85595,276930
TAMIL NADU,Tiruchirappalli,2038981,951216,1087765,2722290,291506,401149
TAMIL NADU,Perambalur,375823,167812,208011,565223,44025,109011
TAMIL NADU,Ariyalur,480604,211022,269582,754894,57524,233438
TAMIL NADU,Cuddalore,1815281,814959,1000322,2605914,227530,634041
TAMIL NADU,Nagapattinam,1213008,572092,640916,1616450,125639,253572
TAMIL NADU,Thiruvarur,946471,443386,503085,1264277,99082,175564
TAMIL NADU,Thanjavur,1790998,846734,944264,2405890,222410,461123
TAMIL NADU,Pudukkottai,1110545,501769,608776,1618345,111731,447346
TAMIL NADU,Sivaganga,959744,433440,526304,1339101,115894,311112
TAMIL NADU,Madurai,2273430,1049620,1223810,3038252,363152,449125
TAMIL NADU,Theni,870080,390677,479403,1245899,101147,270738
TAMIL NADU,Virudhunagar,1398788,638413,760375,1942288,167506,403246
TAMIL NADU,Ramanathapuram,978946,442459,536487,1353445,97405,107292
TAMIL NADU,Thoothukkudi,1349697,646591,703106,1750176,155613,265032
TAMIL NADU,Tirunelveli,2273457,1062747,1210710,3077233,247635,621010
TAMIL NADU,Kanniyakumari,1548738,768197,780541,1870374,254107,210901
TAMIL NADU,Dharmapuri,917709,390110,527599,1506843,112592,512824
TAMIL NADU,Krishnagiri,1187958,520896,667062,1879809,137081,578724
TAMIL NADU,Coimbatore,2635907,1241117,1394790,3458045,440520,519919
TAMIL NADU,Tiruppur,1760566,800943,959623,2479052,179733,552447
PONDICHERRY,Yanam,39274,19355,19919,55626,3836,14923
PONDICHERRY,PONDICHERRY,726649,345703,380946,950289,134067,146861
PONDICHERRY,Mahe,36470,19860,16610,41816,4475,2993
PONDICHERRY,Karaikal,154916,75013,79903,200222,18998,32717
ANDAMAN AND NICOBAR ISLANDS,Nicobars,25332,9935,15397,36842,1300,9781
ANDAMAN AND NICOBAR ISLANDS,North  AND Middle Andaman,78683,35497,43186,105597,5133,22422
ANDAMAN AND NICOBAR ISLANDS,South Andaman,190266,84472,105794,238142,22388,36289
